provincia,municipio,total_2023,hombres_2023,mujeres_2023,cod_ine,municipios
1,001,2975,1539,1436,1001000000,ALEGRÍA-DULANTZI
1,002,10313,5134,5179,1002000000,AMURRIO
1,003,1409,732,677,1003000000,ARAMAIO
1,004,1832,898,934,1004000000,ARTZINIEGA
1,006,232,120,112,1006000000,ARMIÑÓN
1,008,1043,559,484,1008000000,ARRATZUA-UBARRUNDIA
1,009,1609,817,792,1009000000,ASPARRENA
1,010,2918,1479,1439,1010000000,AYALA/AIARA
1,011,295,168,127,1011000000,BAÑOS DE EBRO/MAÑUETA
1,013,897,493,404,1013000000,BARRUNDIA
1,014,451,237,214,1014000000,BERANTEVILLA
1,016,540,321,219,1016000000,BERNEDO
1,017,1072,564,508,1017000000,CAMPEZO/KANPEZU
1,018,1821,974,847,1018000000,ZIGOITIA
1,019,174,92,82,1019000000,KRIPAN
1,020,401,232,169,1020000000,KUARTANGO
1,021,638,332,306,1021000000,ELBURGO/BURGELU
1,022,964,484,480,1022000000,ELCIEGO
1,023,313,151,162,1023000000,ELVILLAR/BILAR
1,027,541,295,246,1027000000,IRURAIZ-GAUNA
1,028,1566,815,751,1028000000,LABASTIDA/BASTIDA
1,030,172,97,75,1030000000,LAGRÁN
1,031,1472,775,697,1031000000,LAGUARDIA
1,032,708,361,347,1032000000,LANCIEGO/LANTZIEGO
1,033,865,445,420,1033000000,LAPUEBLA DE LABARCA
1,034,220,112,108,1034000000,LEZA
1,036,17917,8685,9232,1036000000,LAUDIO/LLODIO
1,037,812,450,362,1037000000,ARRAIA-MAEZTU
1,039,208,110,98,1039000000,MOREDA DE ÁLAVA/MOREDA ARABA
1,041,197,108,89,1041000000,NAVARIDAS
1,042,1198,628,570,1042000000,OKONDO
1,043,3405,1729,1676,1043000000,OYÓN-OION
1,044,302,180,122,1044000000,PEÑACERRADA-URIZAHARRA
1,046,828,494,334,1046000000,ERRIBERAGOITIA/RIBERA ALTA
1,047,1423,762,661,1047000000,ERRIBERABEITIA
1,049,156,95,61,1049000000,AÑANA
1,051,5085,2583,2502,1051000000,AGURAIN/SALVATIERRA
1,052,305,152,153,1052000000,SAMANIEGO
1,053,726,392,334,1053000000,SAN MILLÁN/DONEMILIAGA
1,054,1434,750,684,1054000000,URKABUSTAIZ
1,055,1066,583,483,1055000000,VALDEGOVÍA/GAUBEA
1,056,219,120,99,1056000000,HARANA/VALLE DE ARANA
1,057,285,148,137,1057000000,VILLABUENA DE ÁLAVA/ESKUERNAGA
1,058,2048,1066,982,1058000000,LEGUTIO
1,059,255886,124348,131538,1059000000,VITORIA-GASTEIZ
1,060,249,127,122,1060000000,YÉCORA/IEKORA
1,061,196,106,90,1061000000,ZALDUONDO
1,062,422,231,191,1062000000,ZAMBRANA
1,063,2343,1227,1116,1063000000,ZUIA
1,901,3597,1918,1679,1901000000,IRUÑA OKA/IRUÑA DE OCA
1,902,938,525,413,1902000000,LANTARÓN
2,001,760,369,391,2001000000,ABENGIBRE
2,002,491,268,223,2002000000,ALATOZ
2,003,173206,84585,88621,2003000000,ALBACETE
2,004,655,332,323,2004000000,ALBATANA
2,005,666,350,316,2005000000,ALBOREA
2,006,648,355,293,2006000000,ALCADOZO
2,007,1129,604,525,2007000000,ALCALÁ DEL JÚCAR
2,008,1304,678,626,2008000000,ALCARAZ
2,009,24282,12044,12238,2009000000,ALMANSA
2,010,2268,1186,1082,2010000000,ALPERA
2,011,601,334,267,2011000000,AYNA
2,012,2408,1236,1172,2012000000,BALAZOTE
2,013,134,78,56,2013000000,BALSA DE VES
2,014,414,217,197,2014000000,EL BALLESTERO (EL)
2,015,1849,955,894,2015000000,BARRAX
2,016,567,309,258,2016000000,BIENSERVIDA
2,017,740,391,349,2017000000,BOGARRA
2,018,980,518,462,2018000000,BONETE
2,019,2651,1349,1302,2019000000,EL BONILLO (EL)
2,020,481,249,232,2020000000,CARCELÉN
2,021,1349,729,620,2021000000,CASAS DE JUAN NÚÑEZ
2,022,324,186,138,2022000000,CASAS DE LÁZARO
2,023,556,295,261,2023000000,CASAS DE VES
2,024,4581,2314,2267,2024000000,CASAS-IBÁÑEZ
2,025,10146,5188,4958,2025000000,CAUDETE
2,026,1143,577,566,2026000000,CENIZATE
2,027,302,159,143,2027000000,CORRAL-RUBIO
2,028,131,74,57,2028000000,COTILLAS
2,029,4565,2363,2202,2029000000,CHINCHILLA DE MONTE-ARAGÓN
2,030,3576,1751,1825,2030000000,ELCHE DE LA SIERRA
2,031,617,309,308,2031000000,FÉREZ
2,032,289,157,132,2032000000,FUENSANTA
2,033,2431,1278,1153,2033000000,FUENTE-ÁLAMO
2,034,1827,951,876,2034000000,FUENTEALBILLA
2,035,2611,1356,1255,2035000000,LA GINETA (LA)
2,036,92,50,42,2036000000,GOLOSALVO
2,037,30516,15344,15172,2037000000,HELLÍN
2,038,307,161,146,2038000000,LA HERRERA (LA)
2,039,1147,600,547,2039000000,HIGUERUELA
2,040,614,323,291,2040000000,HOYA-GONZALO
2,041,346,188,158,2041000000,JORQUERA
2,042,929,466,463,2042000000,LETUR
2,043,1291,674,617,2043000000,LEZUZA
2,044,1080,562,518,2044000000,LIÉTOR
2,045,4675,2386,2289,2045000000,MADRIGUERAS
2,046,1491,771,720,2046000000,MAHORA
2,047,139,79,60,2047000000,MASEGOSO
2,048,1435,724,711,2048000000,MINAYA
2,049,824,425,399,2049000000,MOLINICOS
2,050,89,52,37,2050000000,MONTALVOS
2,051,2040,1065,975,2051000000,MONTEALEGRE DEL CASTILLO
2,052,661,362,299,2052000000,MOTILLEJA
2,053,3409,1764,1645,2053000000,MUNERA
2,054,520,273,247,2054000000,NAVAS DE JORQUERA
2,055,1174,659,515,2055000000,NERPIO
2,056,1913,959,954,2056000000,ONTUR
2,057,2209,1135,1074,2057000000,OSSA DE MONTIEL
2,058,351,193,158,2058000000,PATERNA DEL MADERA
2,059,329,191,138,2059000000,PEÑASCOSA
2,060,1447,853,594,2060000000,PEÑAS DE SAN PEDRO
2,061,669,351,318,2061000000,PÉTROLA
2,062,393,213,180,2062000000,POVEDILLA
2,063,1551,813,738,2063000000,POZOHONDO
2,064,392,200,192,2064000000,POZO-LORENTE
2,065,470,255,215,2065000000,POZUELO
2,066,221,122,99,2066000000,LA RECUEJA (LA)
2,067,1326,673,653,2067000000,RIÓPAR
2,068,394,215,179,2068000000,ROBLEDO
2,069,15542,7821,7721,2069000000,LA RODA (LA)
2,070,435,232,203,2070000000,SALOBRE
2,071,1191,612,579,2071000000,SAN PEDRO
2,072,1705,883,822,2072000000,SOCOVOS
2,073,6138,3168,2970,2073000000,TARAZONA DE LA MANCHA
2,074,7824,4053,3771,2074000000,TOBARRA
2,075,1950,998,952,2075000000,VALDEGANGA
2,076,322,166,156,2076000000,VIANOS
2,077,61,34,27,2077000000,VILLA DE VES
2,078,1086,570,516,2078000000,VILLALGORDO DEL JÚCAR
2,079,3929,2011,1918,2079000000,VILLAMALEA
2,080,553,291,262,2080000000,VILLAPALACIOS
2,081,25189,12450,12739,2081000000,VILLARROBLEDO
2,082,114,67,47,2082000000,VILLATOYA
2,083,209,127,82,2083000000,VILLAVALIENTE
2,084,311,171,140,2084000000,VILLAVERDE DE GUADALIMAR
2,085,308,161,147,2085000000,VIVEROS
2,086,2478,1292,1186,2086000000,YESTE
2,901,2703,1374,1329,2901000000,POZO CAÑADA
3,001,608,313,295,3001000000,L'ATZÚBIA (L')
3,002,5067,2566,2501,3002000000,AGOST
3,003,619,338,281,3003000000,AGRES
3,004,1146,566,580,3004000000,AIGÜES
3,005,13092,6682,6410,3005000000,ALBATERA
3,006,1397,701,696,3006000000,ALCALALÍ
3,007,259,130,129,3007000000,ALCOSSER
3,008,188,100,88,3008000000,ALCOLEJA
3,009,59493,29124,30369,3009000000,ALCOI/ALCOY
3,010,419,196,223,3010000000,ALFAFARA
3,011,20518,10102,10416,3011000000,L'ALFÀS DEL PI (L')
3,012,3635,1834,1801,3012000000,ALGORFA
3,013,1395,714,681,3013000000,ALGUEÑA
3,014,349282,168377,180905,3014000000,ALACANT/ALICANTE
3,015,21874,10985,10889,3015000000,ALMORADÍ
3,016,110,54,56,3016000000,ALMUDAINA
3,017,511,258,253,3017000000,L'ALQUERIA D'ASNAR (L')
3,018,23820,11638,12182,3018000000,ALTEA
3,019,21473,10789,10684,3019000000,ASPE
3,020,119,59,60,3020000000,BALONES
3,021,7255,3677,3578,3021000000,BANYERES DE MARIOLA
3,022,173,84,89,3022000000,BENASAU
3,023,1697,846,851,3023000000,BENEIXAMA
3,024,5625,2813,2812,3024000000,BENEJÚZAR
3,025,2023,1046,977,3025000000,BENFERRI
3,026,2353,1191,1162,3026000000,BENIARBEIG
3,027,252,124,128,3027000000,BENIARDÀ
3,028,1089,556,533,3028000000,BENIARRÉS
3,029,537,263,274,3029000000,BENIGEMBLA
3,030,1218,605,613,3030000000,BENIDOLEIG
3,031,72342,35817,36525,3031000000,BENIDORM
3,032,111,60,51,3032000000,BENIFALLIM
3,033,140,78,62,3033000000,BENIFATO
3,034,3473,1686,1787,3034000000,BENIJÓFAR
3,035,737,388,349,3035000000,BENILLOBA
3,036,105,55,50,3036000000,BENILLUP
3,037,534,270,264,3037000000,BENIMANTELL
3,038,422,219,203,3038000000,BENIMARFULL
3,039,105,56,49,3039000000,BENIMASSOT
3,040,455,213,242,3040000000,BENIMELI
3,041,12279,6060,6219,3041000000,BENISSA
3,042,4858,2373,2485,3042000000,EL POBLE NOU DE BENITATXELL (EL)/BENITACHELL
3,043,3607,1762,1845,3043000000,BIAR
3,044,7361,3694,3667,3044000000,BIGASTRO
3,045,440,221,219,3045000000,BOLULLA
3,046,3534,1763,1771,3046000000,BUSOT
3,047,25854,12795,13059,3047000000,CALP
3,048,7708,3973,3735,3048000000,CALLOSA D'EN SARRIÀ
3,049,19484,9932,9552,3049000000,CALLOSA DE SEGURA
3,050,29993,14551,15442,3050000000,EL CAMPELLO (EL)
3,051,442,230,212,3051000000,EL CAMP DE MIRRA (EL)/CAMPO DE MIRRA
3,052,1210,596,614,3052000000,CAÑADA
3,053,11365,5767,5598,3053000000,CASTALLA
3,054,445,235,210,3054000000,CASTELL DE CASTELLS
3,055,9275,4670,4605,3055000000,CATRAL
3,056,11309,5695,5614,3056000000,COCENTAINA
3,057,297,161,136,3057000000,CONFRIDES
3,058,7513,3790,3723,3058000000,COX
3,059,30191,15290,14901,3059000000,CREVILLENT
3,060,136,77,59,3060000000,QUATRETONDETA
3,061,1767,861,906,3061000000,DAYA NUEVA
3,062,667,329,338,3062000000,DAYA VIEJA
3,063,45622,22205,23417,3063000000,DÉNIA
3,064,7919,3949,3970,3064000000,DOLORES
3,065,238293,117760,120533,3065000000,ELX/ELCHE
3,066,53034,25844,27190,3066000000,ELDA
3,067,101,50,51,3067000000,FAGECA
3,068,45,24,21,3068000000,FAMORCA
3,069,8836,4515,4321,3069000000,FINESTRAT
3,070,4618,2364,2254,3070000000,FORMENTERA DEL SEGURA
3,071,6515,3324,3191,3071000000,GATA DE GORGOS
3,072,555,281,274,3072000000,GAIANES
3,073,284,149,135,3073000000,GORGA
3,074,2686,1385,1301,3074000000,GRANJA DE ROCAMORA
3,075,274,135,139,3075000000,EL CASTELL DE GUADALEST (EL)
3,076,17328,8442,8886,3076000000,GUARDAMAR DEL SEGURA
3,077,2698,1381,1317,3077000000,EL FONDÓ DE LES NEUS (EL)/HONDÓN DE LAS NIEVES
3,078,1311,673,638,3078000000,HONDÓN DE LOS FRAILES
3,079,23920,11945,11975,3079000000,IBI
3,080,2108,1072,1036,3080000000,JACARILLA
3,081,2964,1474,1490,3081000000,XALÓ
3,082,29760,14857,14903,3082000000,XÀBIA/JÁVEA
3,083,7032,3433,3599,3083000000,XIXONA/JIJONA
3,084,587,294,293,3084000000,L'ORXA (L')/LORCHA
3,085,946,474,472,3085000000,LLÍBER
3,086,254,135,119,3086000000,MILLENA
3,088,8777,4558,4219,3088000000,MONFORTE DEL CID
3,089,12542,6244,6298,3089000000,MONÒVER/MONÓVAR
3,090,27078,13531,13547,3090000000,MUTXAMEL
3,091,575,269,306,3091000000,MURLA
3,092,9253,4633,4620,3092000000,MURO DE ALCOY
3,093,25771,12801,12970,3093000000,NOVELDA
3,094,18970,9620,9350,3094000000,LA NUCIA (LA)
3,095,7308,3639,3669,3095000000,ONDARA
3,096,7763,3904,3859,3096000000,ONIL
3,097,2379,1165,1214,3097000000,ORBA
3,098,840,430,410,3098000000,ORXETA
3,099,82449,40745,41704,3099000000,ORIHUELA
3,100,1003,489,514,3100000000,PARCENT
3,101,8558,4267,4291,3101000000,PEDREGUER
3,102,10485,5202,5283,3102000000,PEGO
3,103,313,156,157,3103000000,PENÀGUILA
3,104,33914,16751,17163,3104000000,PETRER
3,105,8281,4214,4067,3105000000,EL PINÓS (EL)/PINOSO
3,106,699,378,321,3106000000,PLANES
3,107,5339,2679,2660,3107000000,POLOP
3,109,4800,2392,2408,3109000000,RAFAL
3,110,721,367,354,3110000000,EL RÀFOL D'ALMÚNIA (EL)
3,111,8183,4244,3939,3111000000,REDOVÁN
3,112,1248,640,608,3112000000,RELLEU
3,113,17451,8794,8657,3113000000,ROJALES
3,114,2632,1383,1249,3114000000,LA ROMANA (LA)
3,115,442,215,227,3115000000,SAGRA
3,116,1733,885,848,3116000000,SALINAS
3,117,737,372,365,3117000000,SANET Y NEGRALS
3,118,9443,4758,4685,3118000000,SAN FULGENCIO
3,119,25275,12210,13065,3119000000,SANT JOAN D'ALACANT
3,120,6798,3419,3379,3120000000,SAN MIGUEL DE SALINAS
3,121,37816,18924,18892,3121000000,SANTA POLA
3,122,59928,29575,30353,3122000000,SANT VICENT DEL RASPEIG/SAN VICENTE DEL RASPEIG
3,123,10072,5030,5042,3123000000,SAX
3,124,607,321,286,3124000000,SELLA
3,125,670,344,326,3125000000,SENIJA
3,127,630,334,296,3127000000,TÀRBENA
3,128,12515,6249,6266,3128000000,TEULADA
3,129,1808,948,860,3129000000,TIBI
3,130,40,27,13,3130000000,TOLLOS
3,131,339,164,175,3131000000,TORMOS
3,132,714,376,338,3132000000,LA TORRE DE LES MAÇANES (LA)/TORREMANZANAS
3,133,89290,43252,46038,3133000000,TORREVIEJA
3,134,174,91,83,3134000000,LA VALL D'ALCALÀ (LA)
3,135,230,120,110,3135000000,LA VALL D'EBO (LA)
3,136,581,301,280,3136000000,LA VALL DE GALLINERA (LA)
3,137,873,436,437,3137000000,LA VALL DE LAGUAR (LA)
3,138,5101,2508,2593,3138000000,EL VERGER (EL)
3,139,36093,17835,18258,3139000000,LA VILA JOIOSA (LA)/VILLAJOYOSA
3,140,34144,17102,17042,3140000000,VILLENA
3,901,2763,1302,1461,3901000000,ELS POBLETS (ELS)
3,902,23428,11986,11442,3902000000,PILAR DE LA HORADADA
3,903,5477,2762,2715,3903000000,LOS MONTESINOS (LOS)
3,904,2208,1142,1066,3904000000,SAN ISIDRO
4,001,1255,650,605,4001000000,ABLA
4,002,1275,675,600,4002000000,ABRUCENA
4,003,25195,12858,12337,4003000000,ADRA
4,004,682,366,316,4004000000,ALBANCHEZ
4,005,596,293,303,4005000000,ALBOLODUY
4,006,12311,6276,6035,4006000000,ALBOX
4,007,803,418,385,4007000000,ALCOLEA
4,008,560,307,253,4008000000,ALCÓNTAR
4,009,132,68,64,4009000000,ALCUDIA DE MONTEAGUD
4,010,708,374,334,4010000000,ALHABIA
4,011,3817,1932,1885,4011000000,ALHAMA DE ALMERÍA
4,012,221,108,113,4012000000,ALICÚN
4,013,200578,97592,102986,4013000000,ALMERÍA
4,014,207,105,102,4014000000,ALMÓCITA
4,015,146,82,64,4015000000,ALSODUX
4,016,3417,1780,1637,4016000000,ANTAS
4,017,4439,2201,2238,4017000000,ARBOLEAS
4,018,335,167,168,4018000000,ARMUÑA DE ALMANZORA
4,019,237,124,113,4019000000,BACARES
4,020,326,170,156,4020000000,BAYÁRCAL
4,021,221,104,117,4021000000,BAYARQUE
4,022,1012,506,506,4022000000,BÉDAR
4,023,144,78,66,4023000000,BEIRES
4,024,4643,2294,2349,4024000000,BENAHADUX
4,026,58,33,25,4026000000,BENITAGLA
4,027,254,144,110,4027000000,BENIZALÓN
4,028,241,131,110,4028000000,BENTARIQUE
4,029,12917,6670,6247,4029000000,BERJA
4,030,1153,597,556,4030000000,CANJÁYAR
4,031,3573,1804,1769,4031000000,CANTORIA
4,032,8375,4303,4072,4032000000,CARBONERAS
4,033,109,58,51,4033000000,CASTRO DE FILABRES
4,034,202,109,93,4034000000,CÓBDAR
4,035,15023,7812,7211,4035000000,CUEVAS DEL ALMANZORA
4,036,302,154,148,4036000000,CHERCOS
4,037,1540,795,745,4037000000,CHIRIVEL
4,038,4202,2084,2118,4038000000,DALÍAS
4,041,588,323,265,4041000000,ENIX
4,043,767,446,321,4043000000,FELIX
4,044,2235,1184,1051,4044000000,FINES
4,045,1991,1009,982,4045000000,FIÑANA
4,046,1094,568,526,4046000000,FONDÓN
4,047,3029,1591,1438,4047000000,GÁDOR
4,048,3034,1521,1513,4048000000,LOS GALLARDOS (LOS)
4,049,10336,5397,4939,4049000000,GARRUCHA
4,050,1191,667,524,4050000000,GÉRGAL
4,051,533,258,275,4051000000,HUÉCIJA
4,052,18507,9350,9157,4052000000,HUÉRCAL DE ALMERÍA
4,053,20425,10163,10262,4053000000,HUÉRCAL-OVERA
4,054,451,237,214,4054000000,ÍLLAR
4,055,484,248,236,4055000000,INSTINCIÓN
4,056,198,112,86,4056000000,LAROYA
4,057,1611,811,800,4057000000,LÁUJAR DE ANDARAX
4,058,389,210,179,4058000000,LÍJAR
4,059,1422,715,707,4059000000,LUBRÍN
4,060,704,360,344,4060000000,LUCAINENA DE LAS TORRES
4,061,829,415,414,4061000000,LÚCAR
4,062,5381,2728,2653,4062000000,MACAEL
4,063,1209,625,584,4063000000,MARÍA
4,064,7386,3628,3758,4064000000,MOJÁCAR
4,065,508,269,239,4065000000,NACIMIENTO
4,066,32858,18496,14362,4066000000,NÍJAR
4,067,550,284,266,4067000000,OHANES
4,068,189,104,85,4068000000,OLULA DE CASTRO
4,069,6354,3244,3110,4069000000,OLULA DEL RÍO
4,070,2233,1174,1059,4070000000,ORIA
4,071,437,230,207,4071000000,PADULES
4,072,924,462,462,4072000000,PARTALOA
4,073,387,218,169,4073000000,PATERNA DEL RÍO
4,074,4358,2250,2108,4074000000,PECHINA
4,075,11247,5827,5420,4075000000,PULPÍ
4,076,1551,794,757,4076000000,PURCHENA
4,077,297,149,148,4077000000,RÁGOL
4,078,1594,815,779,4078000000,RIOJA
4,079,106510,55142,51368,4079000000,ROQUETAS DE MAR
4,080,237,126,111,4080000000,SANTA CRUZ DE MARCHENA
4,081,494,256,238,4081000000,SANTA FE DE MONDÚJAR
4,082,288,159,129,4082000000,SENÉS
4,083,2105,1095,1010,4083000000,SERÓN
4,084,379,204,175,4084000000,SIERRO
4,085,521,274,247,4085000000,SOMONTÍN
4,086,2527,1318,1209,4086000000,SORBAS
4,087,229,119,110,4087000000,SUFLÍ
4,088,4032,2095,1937,4088000000,TABERNAS
4,089,958,472,486,4089000000,TABERNO
4,090,373,192,181,4090000000,TAHAL
4,091,400,211,189,4091000000,TERQUE
4,092,3518,1759,1759,4092000000,TÍJOLA
4,093,4092,2103,1989,4093000000,TURRE
4,094,278,154,124,4094000000,TURRILLAS
4,095,820,409,411,4095000000,ULEILA DEL CAMPO
4,096,378,193,185,4096000000,URRÁCAL
4,097,258,146,112,4097000000,VELEFIQUE
4,098,1914,981,933,4098000000,VÉLEZ-BLANCO
4,099,6558,3189,3369,4099000000,VÉLEZ-RUBIO
4,100,18919,9632,9287,4100000000,VERA
4,101,6160,3135,3025,4101000000,VIATOR
4,102,28245,15331,12914,4102000000,VÍCAR
4,103,2972,1505,1467,4103000000,ZURGENA
4,901,581,319,262,4901000000,LAS TRES VILLAS (LAS)
4,902,89975,47198,42777,4902000000,EL EJIDO (EL)
4,903,8778,4831,3947,4903000000,LA MOJONERA (LA)
4,904,2931,1528,1403,4904000000,BALANEGRA
5,001,204,115,89,5001000000,ADANERO
5,002,2727,1387,1340,5002000000,LA ADRADA (LA)
5,005,175,90,85,5005000000,ALBORNOS
5,007,100,53,47,5007000000,ALDEANUEVA DE SANTA CRUZ
5,008,210,104,106,5008000000,ALDEASECA
5,010,148,76,72,5010000000,LA ALDEHUELA (LA)
5,012,135,73,62,5012000000,AMAVIDA
5,013,964,463,501,5013000000,EL ARENAL (EL)
5,014,6464,3143,3321,5014000000,ARENAS DE SAN PEDRO
5,015,60,28,32,5015000000,AREVALILLO
5,016,7768,3769,3999,5016000000,ARÉVALO
5,017,75,44,31,5017000000,AVEINTE
5,018,24,15,9,5018000000,AVELLANEDA
5,019,57741,27485,30256,5019000000,ÁVILA
5,021,2276,1097,1179,5021000000,EL BARCO DE ÁVILA (EL)
5,022,2005,1010,995,5022000000,EL BARRACO (EL)
5,023,176,95,81,5023000000,BARROMÁN
5,024,164,88,76,5024000000,BECEDAS
5,025,70,37,33,5025000000,BECEDILLAS
5,026,178,94,84,5026000000,BERCIAL DE ZAPARDIEL
5,027,326,174,152,5027000000,LAS BERLANAS (LAS)
5,029,88,49,39,5029000000,BERNUY-ZAPARDIEL
5,030,48,28,20,5030000000,BERROCALEJO DE ARAGONA
5,033,169,87,82,5033000000,BLASCOMILLÁN
5,034,15,9,6,5034000000,BLASCONUÑO DE MATACABRAS
5,035,106,55,51,5035000000,BLASCOSANCHO
5,036,107,56,51,5036000000,EL BOHODÓN (EL)
5,037,215,125,90,5037000000,BOHOYO
5,038,180,108,72,5038000000,BONILLA DE LA SIERRA
5,039,39,26,13,5039000000,BRABOS
5,040,57,37,20,5040000000,BULARROS
5,041,1240,650,590,5041000000,BURGOHONDO
5,042,156,74,82,5042000000,CABEZAS DE ALAMBRE
5,043,89,43,46,5043000000,CABEZAS DEL POZO
5,044,234,131,103,5044000000,CABEZAS DEL VILLAR
5,045,88,45,43,5045000000,CABIZUELA
5,046,36,20,16,5046000000,CANALES
5,047,5001,2514,2487,5047000000,CANDELEDA
5,048,97,57,40,5048000000,CANTIVEROS
5,049,419,228,191,5049000000,CARDEÑOSA
5,051,161,91,70,5051000000,LA CARRERA (LA)
5,052,85,45,40,5052000000,CASAS DEL PUERTO
5,053,66,39,27,5053000000,CASASOLA
5,054,1410,726,684,5054000000,CASAVIEJA
5,055,663,361,302,5055000000,CASILLAS
5,056,135,75,60,5056000000,CASTELLANOS DE ZAPARDIEL
5,057,3256,1691,1565,5057000000,CEBREROS
5,058,67,40,27,5058000000,CEPEDA LA MORA
5,059,72,43,29,5059000000,CILLÁN
5,060,99,54,45,5060000000,CISLA
5,061,366,189,177,5061000000,LA COLILLA (LA)
5,062,143,72,71,5062000000,COLLADO DE CONTRERAS
5,063,24,14,10,5063000000,COLLADO DEL MIRÓN
5,064,98,58,40,5064000000,CONSTANZANA
5,065,465,247,218,5065000000,CRESPOS
5,066,508,282,226,5066000000,CUEVAS DEL VALLE
5,067,61,35,26,5067000000,CHAMARTÍN
5,069,76,42,34,5069000000,DONJIMENO
5,070,31,20,11,5070000000,DONVIDAS
5,072,102,53,49,5072000000,ESPINOSA DE LOS CABALLEROS
5,073,271,144,127,5073000000,FLORES DE ÁVILA
5,074,716,370,346,5074000000,FONTIVEROS
5,075,106,52,54,5075000000,FRESNEDILLA
5,076,595,307,288,5076000000,EL FRESNO (EL)
5,077,158,88,70,5077000000,FUENTE EL SAÚZ
5,078,89,52,37,5078000000,FUENTES DE AÑO
5,079,58,34,24,5079000000,GALLEGOS DE ALTAMIROS
5,080,46,23,23,5080000000,GALLEGOS DE SOBRINOS
5,081,41,27,14,5081000000,GARGANTA DEL VILLAR
5,082,547,302,245,5082000000,GAVILANES
5,083,150,78,72,5083000000,GEMUÑO
5,084,49,33,16,5084000000,GILBUENA
5,085,44,22,22,5085000000,GIL GARCÍA
5,086,74,45,29,5086000000,GIMIALCÓN
5,087,167,61,106,5087000000,GOTARRENDURA
5,088,36,17,19,5088000000,GRANDES Y SAN MARTÍN
5,089,488,245,243,5089000000,GUISANDO
5,090,61,32,29,5090000000,GUTIERRE-MUÑOZ
5,092,147,82,65,5092000000,HERNANSANCHO
5,093,487,275,212,5093000000,HERRADÓN DE PINARES
5,094,149,83,66,5094000000,HERREROS DE SUSO
5,095,275,154,121,5095000000,HIGUERA DE LAS DUEÑAS
5,096,80,48,32,5096000000,LA HIJA DE DIOS (LA)
5,097,465,235,230,5097000000,LA HORCAJADA (LA)
5,099,454,253,201,5099000000,HORCAJO DE LAS TORRES
5,100,266,146,120,5100000000,EL HORNILLO (EL)
5,101,328,187,141,5101000000,HOYOCASERO
5,102,2153,1114,1039,5102000000,EL HOYO DE PINARES (EL)
5,103,60,32,28,5103000000,HOYORREDONDO
5,104,29,17,12,5104000000,HOYOS DEL COLLADO
5,105,345,182,163,5105000000,HOYOS DEL ESPINO
5,106,27,15,12,5106000000,HOYOS DE MIGUEL MUÑOZ
5,107,43,26,17,5107000000,HURTUMPASCUAL
5,108,43,24,19,5108000000,JUNCIANA
5,109,440,224,216,5109000000,LANGA
5,110,799,407,392,5110000000,LANZAHÍTA
5,112,116,67,49,5112000000,EL LOSAR DEL BARCO (EL)
5,113,65,30,35,5113000000,LOS LLANOS DE TORMES (LOS)
5,114,1338,690,648,5114000000,MADRIGAL DE LAS ALTAS TORRES
5,115,705,383,322,5115000000,MAELLO
5,116,99,50,49,5116000000,MALPARTIDA DE CORNEJA
5,117,197,112,85,5117000000,MAMBLAS
5,118,71,38,33,5118000000,MANCERA DE ARRIBA
5,119,36,18,18,5119000000,MANJABÁLAGO Y ORTIGOSA DE RIOALMAR
5,120,34,21,13,5120000000,MARLÍN
5,121,356,186,170,5121000000,MARTIHERRERO
5,122,114,61,53,5122000000,MARTÍNEZ
5,123,117,61,56,5123000000,MEDIANA DE VOLTOYA
5,124,78,40,38,5124000000,MEDINILLA
5,125,56,29,27,5125000000,MENGAMUÑOZ
5,126,76,40,36,5126000000,MESEGAR DE CORNEJA
5,127,730,405,325,5127000000,MIJARES
5,128,389,202,187,5128000000,MINGORRÍA
5,129,98,63,35,5129000000,EL MIRÓN (EL)
5,130,109,58,51,5130000000,MIRONCILLO
5,131,88,49,39,5131000000,MIRUEÑA DE LOS INFANZONES
5,132,917,484,433,5132000000,MOMBELTRÁN
5,133,59,32,27,5133000000,MONSALUPE
5,134,53,29,24,5134000000,MORALEJA DE MATACABRAS
5,135,483,252,231,5135000000,MUÑANA
5,136,78,45,33,5136000000,MUÑICO
5,138,301,151,150,5138000000,MUÑOGALINDO
5,139,71,38,33,5139000000,MUÑOGRANDE
5,140,112,57,55,5140000000,MUÑOMER DEL PECO
5,141,103,53,50,5141000000,MUÑOPEPE
5,142,88,48,40,5142000000,MUÑOSANCHO
5,143,51,28,23,5143000000,MUÑOTELLO
5,144,60,33,27,5144000000,NARRILLOS DEL ÁLAMO
5,145,37,24,13,5145000000,NARRILLOS DEL REBOLLAR
5,147,148,81,67,5147000000,NARROS DEL CASTILLO
5,148,28,15,13,5148000000,NARROS DEL PUERTO
5,149,111,57,54,5149000000,NARROS DE SALDUEÑA
5,151,94,51,43,5151000000,NAVACEPEDILLA DE CORNEJA
5,152,677,343,334,5152000000,NAVA DE ARÉVALO
5,153,85,44,41,5153000000,NAVA DEL BARCO
5,154,39,27,12,5154000000,NAVADIJOS
5,155,52,31,21,5155000000,NAVAESCURIAL
5,156,358,212,146,5156000000,NAVAHONDILLA
5,157,218,126,92,5157000000,NAVALACRUZ
5,158,364,193,171,5158000000,NAVALMORAL
5,159,194,98,96,5159000000,NAVALONGUILLA
5,160,323,186,137,5160000000,NAVALOSA
5,161,792,419,373,5161000000,NAVALPERAL DE PINARES
5,162,83,48,35,5162000000,NAVALPERAL DE TORMES
5,163,2164,1083,1081,5163000000,NAVALUENGA
5,164,40,20,20,5164000000,NAVAQUESERA
5,165,442,230,212,5165000000,NAVARREDONDA DE GREDOS
5,166,179,100,79,5166000000,NAVARREDONDILLA
5,167,304,175,129,5167000000,NAVARREVISCA
5,168,5362,2736,2626,5168000000,LAS NAVAS DEL MARQUÉS (LAS)
5,169,238,135,103,5169000000,NAVATALGORDO
5,170,55,25,30,5170000000,NAVATEJARES
5,171,62,34,28,5171000000,NEILA DE SAN MIGUEL
5,172,177,102,75,5172000000,NIHARRA
5,173,91,47,44,5173000000,OJOS-ALBOS
5,174,70,39,31,5174000000,ORBITA
5,175,136,80,56,5175000000,EL OSO (EL)
5,176,276,155,121,5176000000,PADIERNOS
5,177,135,73,62,5177000000,PAJARES DE ADAJA
5,178,407,221,186,5178000000,PALACIOS DE GODA
5,179,221,108,113,5179000000,PAPATRIGO
5,180,61,38,23,5180000000,EL PARRAL (EL)
5,181,38,25,13,5181000000,PASCUALCOBO
5,182,771,405,366,5182000000,PEDRO BERNARDO
5,183,135,71,64,5183000000,PEDRO-RODRÍGUEZ
5,184,303,167,136,5184000000,PEGUERINOS
5,185,103,58,45,5185000000,PEÑALBA DE ÁVILA
5,186,1662,799,863,5186000000,PIEDRAHÍTA
5,187,2136,1061,1075,5187000000,PIEDRALAVES
5,188,34,19,15,5188000000,POVEDA
5,189,493,268,225,5189000000,POYALES DEL HOYO
5,190,56,35,21,5190000000,POZANCO
5,191,119,67,52,5191000000,PRADOSEGAR
5,192,100,61,39,5192000000,PUERTO CASTILLA
5,193,161,90,71,5193000000,RASUEROS
5,194,131,78,53,5194000000,RIOCABADO
5,195,195,120,75,5195000000,RIOFRÍO
5,196,62,29,33,5196000000,RIVILLA DE BARAJAS
5,197,111,60,51,5197000000,SALOBRAL
5,198,77,39,38,5198000000,SALVADIÓS
5,199,54,29,25,5199000000,SAN BARTOLOMÉ DE BÉJAR
5,200,37,21,16,5200000000,SAN BARTOLOMÉ DE CORNEJA
5,201,501,276,225,5201000000,SAN BARTOLOMÉ DE PINARES
5,204,710,369,341,5204000000,SANCHIDRIÁN
5,205,80,41,39,5205000000,SANCHORREJA
5,206,20,13,7,5206000000,SAN ESTEBAN DE LOS PATOS
5,207,745,383,362,5207000000,SAN ESTEBAN DEL VALLE
5,208,39,21,18,5208000000,SAN ESTEBAN DE ZAPARDIEL
5,209,70,46,24,5209000000,SAN GARCÍA DE INGELMOS
5,210,65,33,32,5210000000,SAN JUAN DE LA ENCINILLA
5,211,435,242,193,5211000000,SAN JUAN DE LA NAVA
5,212,234,124,110,5212000000,SAN JUAN DEL MOLINILLO
5,213,80,52,28,5213000000,SAN JUAN DEL OLMO
5,214,32,17,15,5214000000,SAN LORENZO DE TORMES
5,215,161,97,64,5215000000,SAN MARTÍN DE LA VEGA DEL ALBERCHE
5,216,220,127,93,5216000000,SAN MARTÍN DEL PIMPOLLAR
5,217,70,37,33,5217000000,SAN MIGUEL DE CORNEJA
5,218,103,56,47,5218000000,SAN MIGUEL DE SERREZUELA
5,219,43,26,17,5219000000,SAN PASCUAL
5,220,500,265,235,5220000000,SAN PEDRO DEL ARROYO
5,221,322,166,156,5221000000,SANTA CRUZ DEL VALLE
5,222,172,102,70,5222000000,SANTA CRUZ DE PINARES
5,224,101,55,46,5224000000,SANTA MARÍA DEL ARROYO
5,225,374,190,184,5225000000,SANTA MARÍA DEL BERROCAL
5,226,67,42,25,5226000000,SANTA MARÍA DE LOS CABALLEROS
5,227,533,276,257,5227000000,SANTA MARÍA DEL TIÉTAR
5,228,168,106,62,5228000000,SANTIAGO DEL COLLADO
5,229,72,38,34,5229000000,SANTO DOMINGO DE LAS POSADAS
5,230,70,42,28,5230000000,SANTO TOMÉ DE ZABARCOS
5,231,166,93,73,5231000000,SAN VICENTE DE ARÉVALO
5,232,137,70,67,5232000000,LA SERRADA (LA)
5,233,279,154,125,5233000000,SERRANILLOS
5,234,41,20,21,5234000000,SIGERES
5,235,136,63,73,5235000000,SINLABAJOS
5,236,107,62,45,5236000000,SOLANA DE ÁVILA
5,237,149,87,62,5237000000,SOLANA DE RIOALMAR
5,238,779,418,361,5238000000,SOLOSANCHO
5,239,247,146,101,5239000000,SOTALBO
5,240,4870,2425,2445,5240000000,SOTILLO DE LA ADRADA
5,241,4445,2264,2181,5241000000,EL TIEMBLO (EL)
5,242,759,388,371,5242000000,TIÑOSILLOS
5,243,82,47,35,5243000000,TOLBAÑOS
5,244,36,23,13,5244000000,TORMELLAS
5,245,456,223,233,5245000000,TORNADIZOS DE ÁVILA
5,246,37,22,15,5246000000,TÓRTOLES
5,247,223,123,100,5247000000,LA TORRE (LA)
5,249,103,52,51,5249000000,UMBRÍAS
5,251,58,37,21,5251000000,VADILLO DE LA SIERRA
5,252,57,36,21,5252000000,VALDECASA
5,253,76,38,38,5253000000,VEGA DE SANTA MARÍA
5,254,211,106,105,5254000000,VELAYOS
5,256,102,55,47,5256000000,VILLAFLOR
5,257,130,76,54,5257000000,VILLAFRANCA DE LA SIERRA
5,258,115,66,49,5258000000,VILLANUEVA DE GÓMEZ
5,259,97,45,52,5259000000,VILLANUEVA DEL ACERAL
5,260,105,58,47,5260000000,VILLANUEVA DEL CAMPILLO
5,261,37,23,14,5261000000,VILLAR DE CORNEJA
5,262,327,176,151,5262000000,VILLAREJO DEL VALLE
5,263,152,85,67,5263000000,VILLATORO
5,264,47,23,24,5264000000,VIÑEGRA DE MORAÑA
5,265,79,46,33,5265000000,VITA
5,266,83,45,38,5266000000,ZAPARDIEL DE LA CAÑADA
5,267,84,44,40,5267000000,ZAPARDIEL DE LA RIBERA
5,901,248,135,113,5901000000,SAN JUAN DE GREDOS
5,902,315,177,138,5902000000,SANTA MARÍA DEL CUBILLO
5,903,108,67,41,5903000000,DIEGO DEL CARPIO
5,904,110,60,50,5904000000,SANTIAGO DEL TORMES
5,905,230,125,105,5905000000,VILLANUEVA DE ÁVILA
6,001,814,422,392,6001000000,ACEDERA
6,002,5446,2699,2747,6002000000,ACEUCHAL
6,003,797,400,397,6003000000,AHILLONES
6,004,1831,944,887,6004000000,ALANGE
6,005,2002,1033,969,6005000000,LA ALBUERA (LA)
6,006,5063,2533,2530,6006000000,ALBURQUERQUE
6,007,1634,829,805,6007000000,ALCONCHEL
6,008,758,383,375,6008000000,ALCONERA
6,009,261,143,118,6009000000,ALJUCÉN
6,010,1195,604,591,6010000000,ALMENDRAL
6,011,33948,16755,17193,6011000000,ALMENDRALEJO
6,012,4038,2029,2009,6012000000,ARROYO DE SAN SERVÁN
6,013,278,145,133,6013000000,ATALAYA
6,014,7624,3777,3847,6014000000,AZUAGA
6,015,150190,72584,77606,6015000000,BADAJOZ
6,016,3452,1743,1709,6016000000,BARCARROTA
6,017,243,133,110,6017000000,BATERNO
6,018,783,392,391,6018000000,BENQUERENCIA DE LA SERENA
6,019,2219,1104,1115,6019000000,BERLANGA
6,020,2031,1031,1000,6020000000,BIENVENIDA
6,021,1001,507,494,6021000000,BODONAL DE LA SIERRA
6,022,3015,1485,1530,6022000000,BURGUILLOS DEL CERRO
6,023,4583,2289,2294,6023000000,CABEZA DEL BUEY
6,024,1272,662,610,6024000000,CABEZA LA VACA
6,025,6095,3017,3078,6025000000,CALAMONTE
6,026,917,471,446,6026000000,CALERA DE LEÓN
6,027,699,353,346,6027000000,CALZADILLA DE LOS BARROS
6,028,4742,2341,2401,6028000000,CAMPANARIO
6,029,1329,657,672,6029000000,CAMPILLO DE LLERENA
6,030,155,82,73,6030000000,CAPILLA
6,031,518,259,259,6031000000,CARMONITA
6,032,78,43,35,6032000000,EL CARRASCALEJO (EL)
6,033,1380,707,673,6033000000,CASAS DE DON PEDRO
6,034,203,104,99,6034000000,CASAS DE REINA
6,035,852,436,416,6035000000,CASTILBLANCO
6,036,5567,2777,2790,6036000000,CASTUERA
6,037,2004,1046,958,6037000000,LA CODOSERA (LA)
6,038,838,441,397,6038000000,CORDOBILLA DE LÁCARA
6,039,2153,1049,1104,6039000000,LA CORONADA (LA)
6,040,1163,571,592,6040000000,CORTE DE PELEAS
6,041,553,280,273,6041000000,CRISTINA
6,042,1162,574,588,6042000000,CHELES
6,043,814,433,381,6043000000,DON ÁLVARO
6,044,37485,18467,19018,6044000000,DON BENITO
6,045,546,278,268,6045000000,ENTRÍN BAJO
6,046,1510,747,763,6046000000,ESPARRAGALEJO
6,047,960,484,476,6047000000,ESPARRAGOSA DE LA SERENA
6,048,875,435,440,6048000000,ESPARRAGOSA DE LARES
6,049,1050,505,545,6049000000,FERIA
6,050,4753,2326,2427,6050000000,FREGENAL DE LA SIERRA
6,051,1736,847,889,6051000000,FUENLABRADA DE LOS MONTES
6,052,4638,2301,2337,6052000000,FUENTE DE CANTOS
6,053,668,345,323,6053000000,FUENTE DEL ARCO
6,054,6626,3269,3357,6054000000,FUENTE DEL MAESTRE
6,055,2198,1084,1114,6055000000,FUENTES DE LEÓN
6,056,494,260,234,6056000000,GARBAYUELA
6,057,539,270,269,6057000000,GARLITOS
6,058,2297,1131,1166,6058000000,LA GARROVILLA (LA)
6,059,1933,957,976,6059000000,GRANJA DE TORREHERMOSA
6,060,6668,3331,3337,6060000000,GUAREÑA
6,061,1208,606,602,6061000000,LA HABA (LA)
6,062,587,337,250,6062000000,HELECHOSA DE LOS MONTES
6,063,3413,1718,1695,6063000000,HERRERA DEL DUQUE
6,064,901,461,440,6064000000,HIGUERA DE LA SERENA
6,065,350,179,171,6065000000,HIGUERA DE LLERENA
6,066,1882,954,928,6066000000,HIGUERA DE VARGAS
6,067,2199,1113,1086,6067000000,HIGUERA LA REAL
6,068,477,230,247,6068000000,HINOJOSA DEL VALLE
6,069,3418,1709,1709,6069000000,HORNACHOS
6,070,9147,4485,4662,6070000000,JEREZ DE LOS CABALLEROS
6,071,294,150,144,6071000000,LA LAPA (LA)
6,072,2745,1411,1334,6072000000,LOBÓN
6,073,806,408,398,6073000000,LLERA
6,074,5650,2807,2843,6074000000,LLERENA
6,075,489,253,236,6075000000,MAGACELA
6,076,943,473,470,6076000000,MAGUILLA
6,077,356,196,160,6077000000,MALCOCINADO
6,078,524,271,253,6078000000,MALPARTIDA DE LA SERENA
6,079,751,381,370,6079000000,MANCHITA
6,080,2237,1142,1095,6080000000,MEDELLÍN
6,081,1153,600,553,6081000000,MEDINA DE LAS TORRES
6,082,488,264,224,6082000000,MENGABRIL
6,083,59461,28873,30588,6083000000,MÉRIDA
6,084,1223,609,614,6084000000,MIRANDILLA
6,085,4254,2158,2096,6085000000,MONESTERIO
6,086,1280,618,662,6086000000,MONTEMOLÍN
6,087,2237,1103,1134,6087000000,MONTERRUBIO DE LA SERENA
6,088,15312,7557,7755,6088000000,MONTIJO
6,089,703,361,342,6089000000,LA MORERA (LA)
6,090,909,455,454,6090000000,LA NAVA DE SANTIAGO (LA)
6,091,4364,2196,2168,6091000000,NAVALVILLAR DE PELA
6,092,627,313,314,6092000000,NOGALES
6,093,4967,2498,2469,6093000000,OLIVA DE LA FRONTERA
6,094,1669,842,827,6094000000,OLIVA DE MÉRIDA
6,095,11776,5844,5932,6095000000,OLIVENZA
6,096,275,149,126,6096000000,ORELLANA DE LA SIERRA
6,097,2594,1330,1264,6097000000,ORELLANA LA VIEJA
6,098,657,330,327,6098000000,PALOMAS
6,099,1283,663,620,6099000000,LA PARRA (LA)
6,100,831,413,418,6100000000,PEÑALSORDO
6,101,477,242,235,6101000000,PERALEDA DEL ZAUCEJO
6,102,1130,560,570,6102000000,PUEBLA DE ALCOCER
6,103,5812,2924,2888,6103000000,PUEBLA DE LA CALZADA
6,104,707,344,363,6104000000,PUEBLA DE LA REINA
6,105,642,337,305,6105000000,PUEBLA DEL MAESTRE
6,106,448,231,217,6106000000,PUEBLA DEL PRIOR
6,107,1816,923,893,6107000000,PUEBLA DE OBANDO
6,108,2640,1335,1305,6108000000,PUEBLA DE SANCHO PÉREZ
6,109,4469,2256,2213,6109000000,QUINTANA DE LA SERENA
6,110,143,74,69,6110000000,REINA
6,111,614,321,293,6111000000,RENA
6,112,433,228,205,6112000000,RETAMAL DE LLERENA
6,113,3193,1599,1594,6113000000,RIBERA DEL FRESNO
6,114,122,58,64,6114000000,RISCO
6,115,1436,709,727,6115000000,LA ROCA DE LA SIERRA (LA)
6,116,1671,844,827,6116000000,SALVALEÓN
6,117,1573,776,797,6117000000,SALVATIERRA DE LOS BARROS
6,118,154,84,70,6118000000,SANCTI-SPÍRITUS
6,119,879,451,428,6119000000,SAN PEDRO DE MÉRIDA
6,120,3939,1990,1949,6120000000,SANTA AMALIA
6,121,4136,2074,2062,6121000000,SANTA MARTA
6,122,8096,4063,4033,6122000000,LOS SANTOS DE MAIMONA (LOS)
6,123,5262,2642,2620,6123000000,SAN VICENTE DE ALCÁNTARA
6,124,1783,896,887,6124000000,SEGURA DE LEÓN
6,125,1802,910,892,6125000000,SIRUELA
6,126,2538,1276,1262,6126000000,SOLANA DE LOS BARROS
6,127,3274,1646,1628,6127000000,TALARRUBIAS
6,128,5282,2637,2645,6128000000,TALAVERA LA REAL
6,129,662,331,331,6129000000,TÁLIGA
6,130,205,104,101,6130000000,TAMUREJO
6,131,1230,626,604,6131000000,TORRE DE MIGUEL SESMERO
6,132,1010,495,515,6132000000,TORREMAYOR
6,133,2246,1173,1073,6133000000,TORREMEJÍA
6,134,607,318,289,6134000000,TRASIERRA
6,135,1401,713,688,6135000000,TRUJILLANOS
6,136,1747,866,881,6136000000,USAGRE
6,137,1066,551,515,6137000000,VALDECABALLEROS
6,138,1155,566,589,6138000000,VALDETORRES
6,139,502,266,236,6139000000,VALENCIA DE LAS TORRES
6,140,725,375,350,6140000000,VALENCIA DEL MOMBUEY
6,141,1900,958,942,6141000000,VALENCIA DEL VENTOSO
6,142,280,141,139,6142000000,VALVERDE DE BURGUILLOS
6,143,4209,2091,2118,6143000000,VALVERDE DE LEGANÉS
6,144,557,283,274,6144000000,VALVERDE DE LLERENA
6,145,1018,514,504,6145000000,VALVERDE DE MÉRIDA
6,146,1111,567,544,6146000000,VALLE DE LA SERENA
6,147,346,178,168,6147000000,VALLE DE MATAMOROS
6,148,1113,548,565,6148000000,VALLE DE SANTA ANA
6,149,12366,6093,6273,6149000000,VILLAFRANCA DE LOS BARROS
6,150,883,444,439,6150000000,VILLAGARCÍA DE LA TORRE
6,151,1212,592,620,6151000000,VILLAGONZALO
6,152,1441,717,724,6152000000,VILLALBA DE LOS BARROS
6,153,25751,12522,13229,6153000000,VILLANUEVA DE LA SERENA
6,154,3272,1664,1608,6154000000,VILLANUEVA DEL FRESNO
6,155,2101,1132,969,6155000000,VILLAR DEL REY
6,156,1320,683,637,6156000000,VILLAR DE RENA
6,157,403,207,196,6157000000,VILLARTA DE LOS MONTES
6,158,16672,7998,8674,6158000000,ZAFRA
6,159,2766,1385,1381,6159000000,ZAHÍNOS
6,160,3428,1737,1691,6160000000,ZALAMEA DE LA SERENA
6,161,297,146,151,6161000000,ZARZA-CAPILLA
6,162,3369,1690,1679,6162000000,LA ZARZA (LA)
6,901,2762,1388,1374,6901000000,VALDELACALZADA
6,902,1953,977,976,6902000000,PUEBLONUEVO DEL GUADIANA
6,903,2416,1187,1229,6903000000,GUADIANA
7,001,5909,2875,3034,7001000000,ALARÓ
7,002,9748,4896,4852,7002000000,ALAIOR
7,003,21322,10793,10529,7003000000,ALCÚDIA
7,004,6170,3122,3048,7004000000,ALGAIDA
7,005,11833,5936,5897,7005000000,ANDRATX
7,006,8208,4109,4099,7006000000,ARTÀ
7,007,577,309,268,7007000000,BANYALBUFAR
7,008,9172,4537,4635,7008000000,BINISSALEM
7,009,1148,605,543,7009000000,BÚGER
7,010,7286,3549,3737,7010000000,BUNYOLA
7,011,53162,26514,26648,7011000000,CALVIÀ
7,012,2790,1387,1403,7012000000,CAMPANET
7,013,11763,5888,5875,7013000000,CAMPOS
7,014,12340,6251,6089,7014000000,CAPDEPERA
7,015,31443,15689,15754,7015000000,CIUTADELLA DE MENORCA
7,016,4304,2126,2178,7016000000,CONSELL
7,017,1490,733,757,7017000000,COSTITX
7,018,675,328,347,7018000000,DEIÀ
7,019,194,118,76,7019000000,ESCORCA
7,020,5236,2562,2674,7020000000,ESPORLES
7,021,359,192,167,7021000000,ESTELLENCS
7,022,18592,9306,9286,7022000000,FELANITX
7,023,5051,2517,2534,7023000000,FERRERIES
7,024,11171,5746,5425,7024000000,FORMENTERA
7,025,717,351,366,7025000000,FORNALUTX
7,026,51996,26114,25882,7026000000,EIVISSA
7,027,34577,17389,17188,7027000000,INCA
7,028,1589,801,788,7028000000,LLORET DE VISTALEGRE
7,029,6378,3181,3197,7029000000,LLOSETA
7,030,2438,1211,1227,7030000000,LLUBÍ
7,031,39040,19628,19412,7031000000,LLUCMAJOR
7,032,29902,14564,15338,7032000000,MAÓ
7,033,46395,23219,23176,7033000000,MANACOR
7,034,1639,824,815,7034000000,MANCOR DE LA VALL
7,035,2336,1204,1132,7035000000,MARIA DE LA SALUT
7,036,39440,19798,19642,7036000000,MARRATXÍ
7,037,5939,3033,2906,7037000000,ES MERCADAL (ES)
7,038,3144,1586,1558,7038000000,MONTUÏRI
7,039,7825,3952,3873,7039000000,MURO
7,040,423350,206618,216732,7040000000,PALMA
7,041,3118,1530,1588,7041000000,PETRA
7,042,17279,8588,8691,7042000000,POLLENÇA
7,043,5741,2913,2828,7043000000,PORRERES
7,044,14164,7131,7033,7044000000,SA POBLA (SA)
7,045,2055,1021,1034,7045000000,PUIGPUNYENT
7,046,28237,14725,13512,7046000000,SANT ANTONI DE PORTMANY
7,047,3795,1918,1877,7047000000,SENCELLES
7,048,29506,15147,14359,7048000000,SANT JOSEP DE SA TALAIA
7,049,2195,1079,1116,7049000000,SANT JOAN
7,050,6838,3465,3373,7050000000,SANT JOAN DE LABRITJA
7,051,9227,4608,4619,7051000000,SANT LLORENÇ DES CARDASSAR
7,052,7019,3551,3468,7052000000,SANT LLUÍS
7,053,1843,920,923,7053000000,SANTA EUGÈNIA
7,054,41228,20837,20391,7054000000,SANTA EULÀRIA DES RIU
7,055,13160,6782,6378,7055000000,SANTA MARGALIDA
7,056,7552,3767,3785,7056000000,SANTA MARÍA DEL CAMÍ
7,057,12480,6261,6219,7057000000,SANTANYÍ
7,058,4289,2108,2181,7058000000,SELVA
7,059,5044,2496,2548,7059000000,SES SALINES (SES)
7,060,4369,2157,2212,7060000000,SINEU
7,061,13610,6720,6890,7061000000,SÓLLER
7,062,11932,5896,6036,7062000000,SON SERVERA
7,063,2037,1031,1006,7063000000,VALLDEMOSSA
7,064,7670,3855,3815,7064000000,ES CASTELL (ES)
7,065,3699,1868,1831,7065000000,VILAFRANCA DE BONANY
7,901,963,502,461,7901000000,ARIANY
7,902,1563,779,784,7902000000,ES MIGJORN GRAN (ES)
8,001,12848,6462,6386,8001000000,ABRERA
8,002,294,158,136,8002000000,AGUILAR DE SEGARRA
8,003,10139,4946,5193,8003000000,ALELLA
8,004,273,149,124,8004000000,ALPENS
8,005,9296,4666,4630,8005000000,L'AMETLLA DEL VALLÈS (L')
8,006,16342,7948,8394,8006000000,ARENYS DE MAR
8,007,9413,4724,4689,8007000000,ARENYS DE MUNT
8,008,222,116,106,8008000000,ARGENÇOLA
8,009,12846,6349,6497,8009000000,ARGENTONA
8,010,5994,3024,2970,8010000000,ARTÉS
8,011,2249,1120,1129,8011000000,AVIÀ
8,012,2289,1153,1136,8012000000,AVINYÓ
8,013,1732,917,815,8013000000,AVINYONET DEL PENEDÈS
8,014,2567,1242,1325,8014000000,AIGUAFREDA
8,015,225957,111330,114627,8015000000,BADALONA
8,016,2149,1079,1070,8016000000,BAGÀ
8,017,3969,2015,1954,8017000000,BALENYÀ
8,018,3307,1668,1639,8018000000,BALSARENY
8,019,1660122,789758,870364,8019000000,BARCELONA
8,020,7432,3690,3742,8020000000,BEGUES
8,021,72,45,27,8021000000,BELLPRAT
8,022,16959,8350,8609,8022000000,BERGA
8,023,9949,5032,4917,8023000000,BIGUES I RIELLS DEL FAI
8,024,430,243,187,8024000000,BORREDÀ
8,025,2268,1195,1073,8025000000,EL BRUC (EL)
8,026,287,156,131,8026000000,EL BRULL (EL)
8,027,998,513,485,8027000000,LES CABANYES (LES)
8,028,1665,892,773,8028000000,CABRERA D'ANOIA
8,029,4945,2480,2465,8029000000,CABRERA DE MAR
8,030,7799,3858,3941,8030000000,CABRILS
8,031,3566,1797,1769,8031000000,CALAF
8,032,3223,1543,1680,8032000000,CALDES D'ESTRAC
8,033,18109,9023,9086,8033000000,CALDES DE MONTBUI
8,034,1097,565,532,8034000000,CALDERS
8,035,19862,9569,10293,8035000000,CALELLA
8,036,188,95,93,8036000000,CALONGE DE SEGARRA
8,037,2601,1323,1278,8037000000,CALLDETENES
8,038,2099,1029,1070,8038000000,CALLÚS
8,039,589,302,287,8039000000,CAMPINS
8,040,15010,7300,7710,8040000000,CANET DE MAR
8,041,17051,8789,8262,8041000000,CANOVELLES
8,042,3322,1692,1630,8042000000,CÀNOVES I SAMALÚS
8,043,5218,2727,2491,8043000000,CANYELLES
8,044,5417,2679,2738,8044000000,CAPELLADES
8,045,88,42,46,8045000000,CAPOLAT
8,046,19023,9211,9812,8046000000,CARDEDEU
8,047,4569,2256,2313,8047000000,CARDONA
8,048,783,404,379,8048000000,CARME
8,049,1630,811,819,8049000000,CASSERRES
8,050,169,94,75,8050000000,CASTELLAR DEL RIU
8,051,25150,12432,12718,8051000000,CASTELLAR DEL VALLÈS
8,052,171,93,78,8052000000,CASTELLAR DE N'HUG
8,053,4054,2077,1977,8053000000,CASTELLBELL I EL VILAR
8,054,12813,6423,6390,8054000000,CASTELLBISBAL
8,055,778,409,369,8055000000,CASTELLCIR
8,056,68427,33378,35049,8056000000,CASTELLDEFELS
8,057,69,39,30,8057000000,CASTELL DE L'ARENY
8,058,2572,1345,1227,8058000000,CASTELLET I LA GORNAL
8,059,461,236,225,8059000000,CASTELLFOLLIT DEL BOIX
8,060,162,88,74,8060000000,CASTELLFOLLIT DE RIUBREGÓS
8,061,2311,1183,1128,8061000000,CASTELLGALÍ
8,062,1427,746,681,8062000000,CASTELLNOU DE BAGES
8,063,651,311,340,8063000000,CASTELLOLÍ
8,064,2735,1392,1343,8064000000,CASTELLTERÇOL
8,065,1674,856,818,8065000000,CASTELLVÍ DE LA MARCA
8,066,2089,1031,1058,8066000000,CASTELLVÍ DE ROSANES
8,067,7726,3788,3938,8067000000,CENTELLES
8,068,9469,4788,4681,8068000000,CERVELLÓ
8,069,4828,2490,2338,8069000000,COLLBATÓ
8,070,387,193,194,8070000000,COLLSUSPINA
8,071,340,173,167,8071000000,COPONS
8,072,15466,7762,7704,8072000000,CORBERA DE LLOBREGAT
8,073,90303,43825,46478,8073000000,CORNELLÀ DE LLOBREGAT
8,074,16914,8501,8413,8074000000,CUBELLES
8,075,5910,2961,2949,8075000000,DOSRIUS
8,076,22442,11357,11085,8076000000,ESPARREGUERA
8,077,46921,22350,24571,8077000000,ESPLUGUES DE LLOBREGAT
8,078,266,129,137,8078000000,L'ESPUNYOLA (L')
8,079,405,223,182,8079000000,L'ESTANY (L')
8,080,47,26,21,8080000000,FÍGOLS
8,081,482,263,219,8081000000,FOGARS DE MONTCLÚS
8,082,1632,845,787,8082000000,FOGARS DE LA SELVA
8,083,2268,1149,1119,8083000000,FOLGUEROLES
8,084,1558,793,765,8084000000,FONOLLOSA
8,085,1456,786,670,8085000000,FONT-RUBÍ
8,086,20522,10343,10179,8086000000,LES FRANQUESES DEL VALLÈS (LES)
8,087,183,97,86,8087000000,GALLIFA
8,088,17052,8190,8862,8088000000,LA GARRIGA (LA)
8,089,47593,23190,24403,8089000000,GAVÀ
8,090,177,90,87,8090000000,GAIÀ
8,091,7953,4011,3942,8091000000,GELIDA
8,092,4980,2475,2505,8092000000,GIRONELLA
8,093,27,15,12,8093000000,GISCLARENY
8,094,2218,1102,1116,8094000000,LA GRANADA (LA)
8,095,93,57,36,8095000000,GRANERA
8,096,63092,31137,31955,8096000000,GRANOLLERS
8,097,1661,842,819,8097000000,GUALBA
8,098,3430,1753,1677,8098000000,SANT SALVADOR DE GUARDIOLA
8,099,939,483,456,8099000000,GUARDIOLA DE BERGUEDÀ
8,100,2697,1397,1300,8100000000,GURB
8,101,274455,133258,141197,8101000000,L'HOSPITALET DE LLOBREGAT (L')
8,102,41164,20248,20916,8102000000,IGUALADA
8,103,828,427,401,8103000000,JORBA
8,104,952,501,451,8104000000,LA LLACUNA (LA)
8,105,13169,6478,6691,8105000000,LA LLAGOSTA (LA)
8,106,10499,5171,5328,8106000000,LLINARS DEL VALLÈS
8,107,16092,8196,7896,8107000000,LLIÇÀ D'AMUNT
8,108,6714,3413,3301,8108000000,LLIÇÀ DE VALL
8,109,292,143,149,8109000000,LLUÇÀ
8,110,19213,9457,9756,8110000000,MALGRAT DE MAR
8,111,266,135,131,8111000000,MALLA
8,112,21172,10601,10571,8112000000,MANLLEU
8,113,78877,38646,40231,8113000000,MANRESA
8,114,28760,14616,14144,8114000000,MARTORELL
8,115,4904,2460,2444,8115000000,MARTORELLES
8,116,751,389,362,8116000000,LES MASIES DE RODA (LES)
8,117,3222,1593,1629,8117000000,LES MASIES DE VOLTREGÀ (LES)
8,118,24181,11614,12567,8118000000,EL MASNOU (EL)
8,119,9839,5016,4823,8119000000,MASQUEFA
8,120,9899,4956,4943,8120000000,MATADEPERA
8,121,129870,64330,65540,8121000000,MATARÓ
8,122,2628,1351,1277,8122000000,MEDIONA
8,123,26555,12947,13608,8123000000,MOLINS DE REI
8,124,51824,25431,26393,8124000000,MOLLET DEL VALLÈS
8,125,36891,18189,18702,8125000000,MONTCADA I REIXAC
8,126,12462,6155,6307,8126000000,MONTGAT
8,127,3179,1623,1556,8127000000,MONISTROL DE MONTSERRAT
8,128,751,394,357,8128000000,MONISTROL DE CALDERS
8,129,721,379,342,8129000000,MUNTANYOLA
8,130,129,66,63,8130000000,MONTCLAR
8,131,1110,551,559,8131000000,MONTESQUIU
8,132,482,247,235,8132000000,MONTMAJOR
8,133,198,109,89,8133000000,MONTMANEU
8,134,1158,558,600,8134000000,FIGARÓ-MONTMANY
8,135,8825,4312,4513,8135000000,MONTMELÓ
8,136,16800,8425,8375,8136000000,MONTORNÈS DEL VALLÈS
8,137,379,193,186,8137000000,MONTSENY
8,138,6690,3438,3252,8138000000,MOIÀ
8,139,228,118,110,8139000000,MURA
8,140,6109,2976,3133,8140000000,NAVARCLES
8,141,6150,3017,3133,8141000000,NAVÀS
8,142,170,86,84,8142000000,LA NOU DE BERGUEDÀ (LA)
8,143,3720,1922,1798,8143000000,ÒDENA
8,144,890,445,445,8144000000,OLVAN
8,145,3968,2067,1901,8145000000,OLÈRDOLA
8,146,2110,1091,1019,8146000000,OLESA DE BONESVALLS
8,147,24446,12182,12264,8147000000,OLESA DE MONTSERRAT
8,148,4414,2288,2126,8148000000,OLIVELLA
8,149,1218,596,622,8149000000,OLOST
8,150,355,185,170,8150000000,ORÍS
8,151,587,305,282,8151000000,ORISTÀ
8,152,163,86,77,8152000000,ORPÍ
8,153,799,404,395,8153000000,ÒRRIUS
8,154,909,456,453,8154000000,PACS DEL PENEDÈS
8,155,9819,4924,4895,8155000000,PALAFOLLS
8,156,15130,7383,7747,8156000000,PALAU-SOLITÀ I PLEGAMANS
8,157,11736,5833,5903,8157000000,PALLEJÀ
8,158,4325,2160,2165,8158000000,EL PAPIOL (EL)
8,159,18893,9455,9438,8159000000,PARETS DEL VALLÈS
8,160,423,219,204,8160000000,PERAFITA
8,161,17203,8845,8358,8161000000,PIERA
8,162,3188,1619,1569,8162000000,ELS HOSTALETS DE PIEROLA (ELS)
8,163,28751,14229,14522,8163000000,PINEDA DE MAR
8,164,1317,670,647,8164000000,EL PLA DEL PENEDÈS (EL)
8,165,2309,1184,1125,8165000000,LA POBLA DE CLARAMUNT (LA)
8,166,1089,522,567,8166000000,LA POBLA DE LILLET (LA)
8,167,8482,4269,4213,8167000000,POLINYÀ
8,168,523,285,238,8168000000,PONTONS
8,169,65516,32022,33494,8169000000,EL PRAT DE LLOBREGAT (EL)
8,170,558,299,259,8170000000,ELS PRATS DE REI (ELS)
8,171,2681,1344,1337,8171000000,PRATS DE LLUÇANÈS
8,172,28767,14018,14749,8172000000,PREMIÀ DE MAR
8,174,571,279,292,8174000000,PUIGDÀLBER
8,175,4399,2207,2192,8175000000,PUIG-REIG
8,176,219,120,99,8176000000,PUJALT
8,177,40,26,14,8177000000,LA QUAR (LA)
8,178,571,299,272,8178000000,RAJADELL
8,179,923,492,431,8179000000,RELLINARS
8,180,39269,19373,19896,8180000000,RIPOLLET
8,181,10913,5476,5437,8181000000,LA ROCA DEL VALLÈS (LA)
8,182,4101,2118,1983,8182000000,EL PONT DE VILOMARA I ROCAFORT (EL)
8,183,6680,3378,3302,8183000000,RODA DE TER
8,184,80044,39546,40498,8184000000,RUBÍ
8,185,254,143,111,8185000000,RUBIÓ
8,187,218300,105946,112354,8187000000,SABADELL
8,188,151,81,70,8188000000,SAGÀS
8,189,162,84,78,8189000000,SANT PERE SALLAVINERA
8,190,303,172,131,8190000000,SALDES
8,191,6835,3342,3493,8191000000,SALLENT
8,192,7693,3830,3863,8192000000,SANTPEDOR
8,193,1441,752,689,8193000000,SANT ISCLE DE VALLALTA
8,194,37925,18646,19279,8194000000,SANT ADRIÀ DE BESÒS
8,195,109,57,52,8195000000,SANT AGUSTÍ DE LLUÇANÈS
8,196,26910,13208,13702,8196000000,SANT ANDREU DE LA BARCA
8,197,11831,5781,6050,8197000000,SANT ANDREU DE LLAVANERES
8,198,6577,3269,3308,8198000000,SANT ANTONI DE VILAMAJOR
8,199,945,499,446,8199000000,SANT BARTOMEU DEL GRAU
8,200,83919,40828,43091,8200000000,SANT BOI DE LLOBREGAT
8,201,572,296,276,8201000000,SANT BOI DE LLUÇANÈS
8,202,18479,9202,9277,8202000000,SANT CELONI
8,203,3792,1966,1826,8203000000,SANT CEBRIÀ DE VALLALTA
8,204,4190,2095,2095,8204000000,SANT CLIMENT DE LLOBREGAT
8,205,97530,47492,50038,8205000000,SANT CUGAT DEL VALLÈS
8,206,1026,502,524,8206000000,SANT CUGAT SESGARRIGUES
8,207,3045,1507,1538,8207000000,SANT ESTEVE DE PALAUTORDERA
8,208,7906,3936,3970,8208000000,SANT ESTEVE SESROVIRES
8,209,9197,4561,4636,8209000000,SANT FOST DE CAMPSENTELLES
8,210,6527,3298,3229,8210000000,SANT FELIU DE CODINES
8,211,46056,22369,23687,8211000000,SANT FELIU DE LLOBREGAT
8,212,620,326,294,8212000000,SANT FELIU SASSERRA
8,213,9156,4531,4625,8213000000,SANT FRUITÓS DE BAGES
8,214,9230,4552,4678,8214000000,VILASSAR DE DALT
8,215,3711,1865,1846,8215000000,SANT HIPÒLIT DE VOLTREGÀ
8,216,29,15,14,8216000000,SANT JAUME DE FRONTANYÀ
8,217,34568,16725,17843,8217000000,SANT JOAN DESPÍ
8,218,10959,5440,5519,8218000000,SANT JOAN DE VILATORRADA
8,219,21055,10087,10968,8219000000,VILASSAR DE MAR
8,220,3230,1604,1626,8220000000,SANT JULIÀ DE VILATORTA
8,221,20462,9858,10604,8221000000,SANT JUST DESVERN
8,222,2572,1299,1273,8222000000,SANT LLORENÇ D'HORTONS
8,223,2545,1271,1274,8223000000,SANT LLORENÇ SAVALL
8,224,1247,629,618,8224000000,SANT MARTÍ DE CENTELLES
8,225,121,60,61,8225000000,SANT MARTÍ D'ALBARS
8,226,1268,638,630,8226000000,SANT MARTÍ DE TOUS
8,227,3380,1692,1688,8227000000,SANT MARTÍ SARROCA
8,228,359,186,173,8228000000,SANT MARTÍ SESGUEIOLES
8,229,633,326,307,8229000000,SANT MATEU DE BAGES
8,230,10532,5241,5291,8230000000,PREMIÀ DE DALT
8,231,31786,15702,16084,8231000000,SANT PERE DE RIBES
8,232,2462,1244,1218,8232000000,SANT PERE DE RIUDEBITLLES
8,233,2568,1320,1248,8233000000,SANT PERE DE TORELLÓ
8,234,4862,2460,2402,8234000000,SANT PERE DE VILAMAJOR
8,235,5791,2829,2962,8235000000,SANT POL DE MAR
8,236,2407,1229,1178,8236000000,SANT QUINTÍ DE MEDIONA
8,237,2115,1026,1089,8237000000,SANT QUIRZE DE BESORA
8,238,20241,9900,10341,8238000000,SANT QUIRZE DEL VALLÈS
8,239,677,363,314,8239000000,SANT QUIRZE SAFAJA
8,240,12945,6373,6572,8240000000,SANT SADURNÍ D'ANOIA
8,241,89,53,36,8241000000,SANT SADURNÍ D'OSORMORT
8,242,293,148,145,8242000000,MARGANELL
8,243,184,102,82,8243000000,SANTA CECÍLIA DE VOLTREGÀ
8,244,8393,4077,4316,8244000000,SANTA COLOMA DE CERVELLÓ
8,245,119862,59151,60711,8245000000,SANTA COLOMA DE GRAMENET
8,246,2303,1179,1124,8246000000,SANTA EUGÈNIA DE BERGA
8,247,1450,728,722,8247000000,SANTA EULÀLIA DE RIUPRIMER
8,248,7846,3928,3918,8248000000,SANTA EULÀLIA DE RONÇANA
8,249,362,179,183,8249000000,SANTA FE DEL PENEDÈS
8,250,10456,5247,5209,8250000000,SANTA MARGARIDA DE MONTBUI
8,251,7650,3887,3763,8251000000,SANTA MARGARIDA I ELS MONJOS
8,252,33322,16345,16977,8252000000,BARBERÀ DEL VALLÈS
8,253,165,89,76,8253000000,SANTA MARIA DE BESORA
8,254,2263,1123,1140,8254000000,L'ESQUIROL (L')
8,255,174,89,85,8255000000,SANTA MARIA DE MERLÈS
8,256,881,446,435,8256000000,SANTA MARIA DE MARTORELLES
8,257,138,74,64,8257000000,SANTA MARIA DE MIRALLES
8,258,1086,543,543,8258000000,SANTA MARIA D'OLÓ
8,259,9872,4965,4907,8259000000,SANTA MARIA DE PALAUTORDERA
8,260,25928,12977,12951,8260000000,SANTA PERPÈTUA DE MOGODA
8,261,3887,1946,1941,8261000000,SANTA SUSANNA
8,262,10068,5067,5001,8262000000,SANT VICENÇ DE CASTELLET
8,263,28406,14094,14312,8263000000,SANT VICENÇ DELS HORTS
8,264,6701,3333,3368,8264000000,SANT VICENÇ DE MONTALT
8,265,2083,1047,1036,8265000000,SANT VICENÇ DE TORELLÓ
8,266,57879,28138,29741,8266000000,CERDANYOLA DEL VALLÈS
8,267,9474,4791,4683,8267000000,SENTMENAT
8,268,1196,601,595,8268000000,CERCS
8,269,3770,1949,1821,8269000000,SEVA
8,270,31954,16010,15944,8270000000,SITGES
8,271,86,34,52,8271000000,SOBREMUNT
8,272,217,116,101,8272000000,SORA
8,273,3243,1674,1569,8273000000,SUBIRATS
8,274,6046,2930,3116,8274000000,SÚRIA
8,275,340,173,167,8275000000,TAVÈRNOLES
8,276,344,179,165,8276000000,TAGAMANENT
8,277,223,122,101,8277000000,TALAMANCA
8,278,6809,3423,3386,8278000000,TARADELL
8,279,225277,110614,114663,8279000000,TERRASSA
8,280,126,68,58,8280000000,TAVERTET
8,281,6696,3285,3411,8281000000,TEIÀ
8,282,9198,4442,4756,8282000000,TIANA
8,283,8455,4162,4293,8283000000,TONA
8,284,18409,9338,9071,8284000000,TORDERA
8,285,14902,7447,7455,8285000000,TORELLÓ
8,286,4018,2096,1922,8286000000,LA TORRE DE CLARAMUNT (LA)
8,287,1499,777,722,8287000000,TORRELAVIT
8,288,2608,1374,1234,8288000000,TORRELLES DE FOIX
8,289,6225,3080,3145,8289000000,TORRELLES DE LLOBREGAT
8,290,2162,1077,1085,8290000000,ULLASTRELL
8,291,7460,3851,3609,8291000000,VACARISSES
8,292,1428,732,696,8292000000,VALLBONA D'ANOIA
8,293,273,144,129,8293000000,VALLCEBRE
8,294,3204,1630,1574,8294000000,VALLGORGUINA
8,295,15823,7897,7926,8295000000,VALLIRANA
8,296,2705,1389,1316,8296000000,VALLROMANES
8,297,179,101,78,8297000000,VECIANA
8,298,48364,24478,23886,8298000000,VIC
8,299,434,233,201,8299000000,VILADA
8,300,7809,3866,3943,8300000000,VILADECAVALLS
8,301,66677,32866,33811,8301000000,VILADECANS
8,302,12758,6399,6359,8302000000,VILANOVA DEL CAMÍ
8,303,310,147,163,8303000000,VILANOVA DE SAU
8,304,1141,584,557,8304000000,VILOBÍ DEL PENEDÈS
8,305,40714,19816,20898,8305000000,VILAFRANCA DEL PENEDÈS
8,306,753,384,369,8306000000,VILALBA SASSERRA
8,307,68854,33250,35604,8307000000,VILANOVA I LA GELTRÚ
8,308,173,89,84,8308000000,VIVER I SERRATEIX
8,901,277,135,142,8901000000,RUPIT I PRUIT
8,902,5600,2839,2761,8902000000,VILANOVA DEL VALLÈS
8,903,242,135,107,8903000000,SANT JULIÀ DE CERDANYOLA
8,904,13074,6391,6683,8904000000,BADIA DEL VALLÈS
8,905,3040,1484,1556,8905000000,LA PALMA DE CERVELLÓ (LA)
9,001,28,18,10,9001000000,ABAJAS
9,003,202,98,104,9003000000,ADRADA DE HAZA
9,006,60,40,20,9006000000,AGUAS CÁNDIDAS
9,007,54,34,20,9007000000,AGUILAR DE BUREBA
9,009,221,120,101,9009000000,ALBILLOS
9,010,41,29,12,9010000000,ALCOCERO DE MOLA
9,011,71,47,24,9011000000,ALFOZ DE BRICIA
9,012,99,52,47,9012000000,ALFOZ DE SANTA GADEA
9,013,46,27,19,9013000000,ALTABLE
9,014,201,125,76,9014000000,LOS ALTOS (LOS)
9,016,114,57,57,9016000000,AMEYUGO
9,017,157,102,55,9017000000,ANGUIX
9,018,33626,16349,17277,9018000000,ARANDA DE DUERO
9,019,156,102,54,9019000000,ARANDILLA
9,020,276,152,124,9020000000,ARAUZO DE MIEL
9,021,48,24,24,9021000000,ARAUZO DE SALCE
9,022,64,39,25,9022000000,ARAUZO DE TORRE
9,023,1826,956,870,9023000000,ARCOS
9,024,174,105,69,9024000000,ARENILLAS DE RIOPISUERGA
9,025,110,58,52,9025000000,ARIJA
9,026,431,260,171,9026000000,ARLANZÓN
9,027,44,26,18,9027000000,ARRAYA DE OCA
9,029,180,106,74,9029000000,ATAPUERCA
9,030,162,98,64,9030000000,LOS AUSINES (LOS)
9,032,101,55,46,9032000000,AVELLANOSA DE MUÑÓ
9,033,78,42,36,9033000000,BAHABÓN DE ESGUEVA
9,034,302,166,136,9034000000,LOS BALBASES (LOS)
9,035,318,183,135,9035000000,BAÑOS DE VALDEARADOS
9,036,34,20,14,9036000000,BAÑUELOS DE BUREBA
9,037,106,65,41,9037000000,BARBADILLO DE HERREROS
9,038,141,76,65,9038000000,BARBADILLO DEL MERCADO
9,039,69,39,30,9039000000,BARBADILLO DEL PEZ
9,041,31,18,13,9041000000,BARRIO DE MUÑÓ
9,043,186,99,87,9043000000,LOS BARRIOS DE BUREBA (LOS)
9,044,57,31,26,9044000000,BARRIOS DE COLINA
9,045,298,174,124,9045000000,BASCONCILLOS DEL TOZO
9,046,20,14,6,9046000000,BASCUÑANA
9,047,56,28,28,9047000000,BELBIMBRE
9,048,1798,909,889,9048000000,BELORADO
9,050,50,29,21,9050000000,BERBERANA
9,051,191,108,83,9051000000,BERLANGAS DE ROA
9,052,26,19,7,9052000000,BERZOSA DE BUREBA
9,054,101,60,41,9054000000,BOZOÓ
9,055,47,31,16,9055000000,BRAZACORTA
9,056,6414,3217,3197,9056000000,BRIVIESCA
9,057,194,117,77,9057000000,BUGEDO
9,058,626,346,280,9058000000,BUNIEL
9,059,174451,82934,91517,9059000000,BURGOS
9,060,140,78,62,9060000000,BUSTO DE BUREBA
9,061,158,87,71,9061000000,CABAÑES DE ESGUEVA
9,062,39,16,23,9062000000,CABEZÓN DE LA SIERRA
9,063,245,142,103,9063000000,CAVIA
9,064,393,200,193,9064000000,CALERUEGA
9,065,174,96,78,9065000000,CAMPILLO DE ARANDA
9,066,50,35,15,9066000000,CAMPOLARA
9,067,422,230,192,9067000000,CANICOSA DE LA SIERRA
9,068,22,13,9,9068000000,CANTABRANA
9,070,41,26,15,9070000000,CARAZO
9,071,50,27,23,9071000000,CARCEDO DE BUREBA
9,072,488,261,227,9072000000,CARCEDO DE BURGOS
9,073,1452,786,666,9073000000,CARDEÑADIJO
9,074,1195,632,563,9074000000,CARDEÑAJIMENO
9,075,109,64,45,9075000000,CARDEÑUELA RIOPICO
9,076,24,18,6,9076000000,CARRIAS
9,077,28,14,14,9077000000,CASCAJARES DE BUREBA
9,078,28,15,13,9078000000,CASCAJARES DE LA SIERRA
9,079,50,30,20,9079000000,CASTELLANOS DE CASTRO
9,082,35,20,15,9082000000,CASTILDELGADO
9,083,26,13,13,9083000000,CASTIL DE PEONES
9,084,165,107,58,9084000000,CASTRILLO DE LA REINA
9,085,613,330,283,9085000000,CASTRILLO DE LA VEGA
9,086,835,462,373,9086000000,CASTRILLO DEL VAL
9,088,57,36,21,9088000000,CASTRILLO DE RIOPISUERGA
9,090,51,26,25,9090000000,CASTRILLO MOTA DE JUDÍOS
9,091,763,399,364,9091000000,CASTROJERIZ
9,093,183,104,79,9093000000,CAYUELA
9,094,56,34,22,9094000000,CEBRECOS
9,095,91,45,46,9095000000,CELADA DEL CAMINO
9,098,494,274,220,9098000000,CEREZO DE RÍO TIRÓN
9,100,50,34,16,9100000000,CERRATÓN DE JUARROS
9,101,75,47,28,9101000000,CIADONCHA
9,102,34,22,12,9102000000,CILLAPERLATA
9,103,203,124,79,9103000000,CILLERUELO DE ABAJO
9,104,48,27,21,9104000000,CILLERUELO DE ARRIBA
9,105,107,61,46,9105000000,CIRUELOS DE CERVERA
9,108,616,346,270,9108000000,COGOLLOS
9,109,1479,810,669,9109000000,CONDADO DE TREVIÑO
9,110,91,55,36,9110000000,CONTRERAS
9,112,100,62,38,9112000000,CORUÑA DEL CONDE
9,113,529,288,241,9113000000,COVARRUBIAS
9,114,103,56,47,9114000000,CUBILLO DEL CAMPO
9,115,101,58,43,9115000000,CUBO DE BUREBA
9,117,95,50,45,9117000000,LA CUEVA DE ROA (LA)
9,119,44,19,25,9119000000,CUEVAS DE SAN CLEMENTE
9,120,43,23,20,9120000000,ENCÍO
9,122,82,51,31,9122000000,ESPINOSA DE CERVERA
9,123,44,26,18,9123000000,ESPINOSA DEL CAMINO
9,124,1633,838,795,9124000000,ESPINOSA DE LOS MONTEROS
9,125,636,366,270,9125000000,ESTÉPAR
9,127,56,32,24,9127000000,FONTIOSO
9,128,98,54,44,9128000000,FRANDOVÍNEZ
9,129,101,65,36,9129000000,FRESNEDA DE LA SIERRA TIRÓN
9,130,68,44,24,9130000000,FRESNEÑA
9,131,688,358,330,9131000000,FRESNILLO DE LAS DUEÑAS
9,132,167,101,66,9132000000,FRESNO DE RÍO TIRÓN
9,133,47,27,20,9133000000,FRESNO DE RODILLA
9,134,267,140,127,9134000000,FRÍAS
9,135,43,26,17,9135000000,FUENTEBUREBA
9,136,232,132,100,9136000000,FUENTECÉN
9,137,266,137,129,9137000000,FUENTELCÉSPED
9,138,104,56,48,9138000000,FUENTELISENDO
9,139,99,67,32,9139000000,FUENTEMOLINOS
9,140,135,80,55,9140000000,FUENTENEBRO
9,141,809,425,384,9141000000,FUENTESPINA
9,143,29,18,11,9143000000,GALBARROS
9,144,42,29,13,9144000000,LA GALLEGA (LA)
9,148,107,54,53,9148000000,GRIJALBA
9,149,59,42,17,9149000000,GRISALEÑA
9,151,594,324,270,9151000000,GUMIEL DE IZÁN
9,152,385,214,171,9152000000,GUMIEL DE MERCADO
9,154,150,92,58,9154000000,HACINAS
9,155,29,20,9,9155000000,HAZA
9,159,68,40,28,9159000000,HONTANAS
9,160,93,60,33,9160000000,HONTANGAS
9,162,168,93,75,9162000000,HONTORIA DE LA CANTERA
9,163,617,331,286,9163000000,HONTORIA DEL PINAR
9,164,164,100,64,9164000000,HONTORIA DE VALDEARADOS
9,166,99,53,46,9166000000,LAS HORMAZAS (LAS)
9,167,54,29,25,9167000000,HORNILLOS DEL CAMINO
9,168,306,170,136,9168000000,LA HORRA (LA)
9,169,107,71,36,9169000000,HORTIGÜELA
9,170,208,111,97,9170000000,HOYALES DE ROA
9,172,157,85,72,9172000000,HUÉRMECES
9,173,125,69,56,9173000000,HUERTA DE ARRIBA
9,174,880,481,399,9174000000,HUERTA DE REY
9,175,115,79,36,9175000000,HUMADA
9,176,54,35,19,9176000000,HURONES
9,177,1411,748,663,9177000000,IBEAS DE JUARROS
9,178,33,25,8,9178000000,IBRILLOS
9,179,47,24,23,9179000000,IGLESIARRUBIA
9,180,144,76,68,9180000000,IGLESIAS
9,181,282,150,132,9181000000,ISAR
9,182,78,47,31,9182000000,ITERO DEL CASTILLO
9,183,42,28,14,9183000000,JARAMILLO DE LA FUENTE
9,184,10,8,2,9184000000,JARAMILLO QUEMADO
9,189,124,71,53,9189000000,JUNTA DE TRASLALOMA
9,190,80,43,37,9190000000,JUNTA DE VILLALBA DE LOSA
9,191,43,26,17,9191000000,JURISDICCIÓN DE LARA
9,192,68,40,28,9192000000,JURISDICCIÓN DE SAN ZADORNIL
9,194,2585,1293,1292,9194000000,LERMA
9,195,48,35,13,9195000000,LLANO DE BUREBA
9,196,148,89,59,9196000000,MADRIGAL DEL MONTE
9,197,188,111,77,9197000000,MADRIGALEJO DEL MONTE
9,198,101,57,44,9198000000,MAHAMUD
9,199,112,69,43,9199000000,MAMBRILLA DE CASTREJÓN
9,200,55,32,23,9200000000,MAMBRILLAS DE LARA
9,201,29,15,14,9201000000,MAMOLAR
9,202,23,14,9,9202000000,MANCILES
9,206,55,32,23,9206000000,MAZUELA
9,208,192,105,87,9208000000,MECERREYES
9,209,5866,2986,2880,9209000000,MEDINA DE POMAR
9,211,1525,849,676,9211000000,MELGAR DE FERNAMENTAL
9,213,274,162,112,9213000000,MERINDAD DE CUESTA-URRIA
9,214,739,445,294,9214000000,MERINDAD DE MONTIJA
9,215,427,247,180,9215000000,MERINDAD DE SOTOSCUEVA
9,216,418,213,205,9216000000,MERINDAD DE VALDEPORRES
9,217,403,224,179,9217000000,MERINDAD DE VALDIVIELSO
9,218,417,218,199,9218000000,MILAGROS
9,219,35639,17586,18053,9219000000,MIRANDA DE EBRO
9,220,94,60,34,9220000000,MIRAVECHE
9,221,777,426,351,9221000000,MODÚBAR DE LA EMPAREDADA
9,223,39,26,13,9223000000,MONASTERIO DE LA SIERRA
9,224,158,86,72,9224000000,MONASTERIO DE RODILLA
9,225,85,50,35,9225000000,MONCALVILLO
9,226,58,34,24,9226000000,MONTERRUBIO DE LA DEMANDA
9,227,150,85,65,9227000000,MONTORIO
9,228,166,90,76,9228000000,MORADILLO DE ROA
9,229,206,110,96,9229000000,NAVA DE ROA
9,230,26,12,14,9230000000,NAVAS DE BUREBA
9,231,52,34,18,9231000000,NEBREDA
9,232,124,69,55,9232000000,NEILA
9,235,186,107,79,9235000000,OLMEDILLO DE ROA
9,236,35,20,15,9236000000,OLMILLOS DE MUÑÓ
9,238,967,502,465,9238000000,OÑA
9,239,47,25,22,9239000000,OQUILLAS
9,241,358,200,158,9241000000,ORBANEJA RIOPICO
9,242,66,41,25,9242000000,PADILLA DE ABAJO
9,243,89,57,32,9243000000,PADILLA DE ARRIBA
9,244,69,33,36,9244000000,PADRONES DE BUREBA
9,246,695,357,338,9246000000,PALACIOS DE LA SIERRA
9,247,19,9,10,9247000000,PALACIOS DE RIOPISUERGA
9,248,95,56,39,9248000000,PALAZUELOS DE LA SIERRA
9,249,55,30,25,9249000000,PALAZUELOS DE MUÑÓ
9,250,288,158,130,9250000000,PAMPLIEGA
9,251,433,228,205,9251000000,PANCORBO
9,253,106,65,41,9253000000,PARDILLA
9,255,88,55,33,9255000000,PARTIDO DE LA SIERRA EN TOBALINA
9,256,478,285,193,9256000000,PEDROSA DE DUERO
9,257,90,54,36,9257000000,PEDROSA DEL PÁRAMO
9,258,169,95,74,9258000000,PEDROSA DEL PRÍNCIPE
9,259,259,154,105,9259000000,PEDROSA DE RÍO ÚRBEL
9,261,470,243,227,9261000000,PEÑARANDA DE DUERO
9,262,172,95,77,9262000000,PERAL DE ARLANZA
9,265,37,22,15,9265000000,PIÉRNIGAS
9,266,95,63,32,9266000000,PINEDA DE LA SIERRA
9,267,106,65,41,9267000000,PINEDA TRASMONTE
9,268,100,60,40,9268000000,PINILLA DE LOS BARRUECOS
9,269,35,20,15,9269000000,PINILLA DE LOS MOROS
9,270,166,94,72,9270000000,PINILLA TRASMONTE
9,272,286,158,128,9272000000,POZA DE LA SAL
9,273,59,36,23,9273000000,PRÁDANOS DE BUREBA
9,274,1076,552,524,9274000000,PRADOLUENGO
9,275,198,115,83,9275000000,PRESENCIO
9,276,552,287,265,9276000000,LA PUEBLA DE ARGANZÓN (LA)
9,277,117,75,42,9277000000,PUENTEDURA
9,279,249,148,101,9279000000,QUEMADA
9,280,32,18,14,9280000000,QUINTANABUREBA
9,281,150,79,71,9281000000,QUINTANA DEL PIDIO
9,283,49,26,23,9283000000,QUINTANAÉLEZ
9,287,284,153,131,9287000000,QUINTANAORTUÑO
9,288,106,53,53,9288000000,QUINTANAPALLA
9,289,1534,801,733,9289000000,QUINTANAR DE LA SIERRA
9,292,69,39,30,9292000000,QUINTANAVIDES
9,294,112,71,41,9294000000,QUINTANILLA DE LA MATA
9,295,51,26,25,9295000000,QUINTANILLA DEL COCO
9,297,384,226,158,9297000000,LAS QUINTANILLAS (LAS)
9,298,70,40,30,9298000000,QUINTANILLA SAN GARCÍA
9,301,898,477,421,9301000000,QUINTANILLA VIVAR
9,302,101,63,38,9302000000,RABANERA DEL PINAR
9,303,83,52,31,9303000000,RÁBANOS
9,304,254,125,129,9304000000,RABÉ DE LAS CALZADAS
9,306,96,57,39,9306000000,REBOLLEDO DE LA TORRE
9,307,104,63,41,9307000000,REDECILLA DEL CAMINO
9,308,68,41,27,9308000000,REDECILLA DEL CAMPO
9,309,317,181,136,9309000000,REGUMIEL DE LA SIERRA
9,310,16,12,4,9310000000,REINOSO
9,311,62,37,25,9311000000,RETUERTA
9,312,95,56,39,9312000000,LA REVILLA Y AHEDO (LA)
9,314,102,63,39,9314000000,REVILLA DEL CAMPO
9,315,611,325,286,9315000000,REVILLARRUZ
9,316,119,69,50,9316000000,REVILLA VALLEJERA
9,317,19,7,12,9317000000,REZMONDO
9,318,54,35,19,9318000000,RIOCAVADO DE LA SIERRA
9,321,2220,1145,1075,9321000000,ROA
9,323,59,37,22,9323000000,ROJAS
9,325,175,104,71,9325000000,ROYUELA DE RÍO FRANCO
9,326,202,114,88,9326000000,RUBENA
9,327,32,15,17,9327000000,RUBLACEDO DE ABAJO
9,328,69,33,36,9328000000,RUCANDIO
9,329,135,79,56,9329000000,SALAS DE BUREBA
9,330,1970,1018,952,9330000000,SALAS DE LOS INFANTES
9,332,203,118,85,9332000000,SALDAÑA DE BURGOS
9,334,48,34,14,9334000000,SALINILLAS DE BUREBA
9,335,93,60,33,9335000000,SAN ADRIÁN DE JUARROS
9,337,142,76,66,9337000000,SAN JUAN DEL MONTE
9,338,327,190,137,9338000000,SAN MAMÉS DE BURGOS
9,339,143,87,56,9339000000,SAN MARTÍN DE RUBIALES
9,340,63,46,17,9340000000,SAN MILLÁN DE LARA
9,343,105,63,42,9343000000,SANTA CECILIA
9,345,136,77,59,9345000000,SANTA CRUZ DE LA SALCEDA
9,346,101,66,35,9346000000,SANTA CRUZ DEL VALLE URBIÓN
9,347,161,87,74,9347000000,SANTA GADEA DEL CID
9,348,155,87,68,9348000000,SANTA INÉS
9,350,509,279,230,9350000000,SANTA MARÍA DEL CAMPO
9,351,64,47,17,9351000000,SANTA MARÍA DEL INVIERNO
9,352,101,69,32,9352000000,SANTA MARÍA DEL MERCADILLO
9,353,91,55,36,9353000000,SANTA MARÍA RIVARREDONDA
9,354,41,27,14,9354000000,SANTA OLALLA DE BUREBA
9,355,79,44,35,9355000000,SANTIBÁÑEZ DE ESGUEVA
9,356,72,41,31,9356000000,SANTIBÁÑEZ DEL VAL
9,358,261,165,96,9358000000,SANTO DOMINGO DE SILOS
9,360,29,19,10,9360000000,SAN VICENTE DEL VALLE
9,361,128,72,56,9361000000,SARGENTES DE LA LORA
9,362,260,137,123,9362000000,SARRACÍN
9,363,934,530,404,9363000000,SASAMÓN
9,365,27,20,7,9365000000,LA SEQUERA DE HAZA (LA)
9,366,74,45,29,9366000000,SOLARANA
9,368,21,12,9,9368000000,SORDILLOS
9,369,479,249,230,9369000000,SOTILLO DE LA RIBERA
9,372,296,167,129,9372000000,SOTRAGERO
9,373,428,253,175,9373000000,SOTRESGUDO
9,374,117,72,45,9374000000,SUSINOS DEL PÁRAMO
9,375,59,31,28,9375000000,TAMARÓN
9,377,799,427,372,9377000000,TARDAJOS
9,378,34,19,15,9378000000,TEJADA
9,380,67,34,33,9380000000,TERRADILLOS DE ESGUEVA
9,381,26,14,12,9381000000,TINIEBLAS DE LA SIERRA
9,382,25,18,7,9382000000,TOBAR
9,384,311,169,142,9384000000,TORDÓMAR
9,386,82,46,36,9386000000,TORRECILLA DEL MONTE
9,387,117,70,47,9387000000,TORREGALINDO
9,388,32,21,11,9388000000,TORRELARA
9,389,69,40,29,9389000000,TORREPADRE
9,390,576,299,277,9390000000,TORRESANDINO
9,391,406,222,184,9391000000,TÓRTOLES DE ESGUEVA
9,392,53,28,25,9392000000,TOSANTOS
9,394,733,363,370,9394000000,TRESPADERNE
9,395,140,85,55,9395000000,TUBILLA DEL AGUA
9,396,167,88,79,9396000000,TUBILLA DEL LAGO
9,398,62,44,18,9398000000,ÚRBEL DEL CASTILLO
9,400,371,200,171,9400000000,VADOCONDES
9,403,99,60,39,9403000000,VALDEANDE
9,405,118,68,50,9405000000,VALDEZATE
9,406,345,199,146,9406000000,VALDORROS
9,407,28,14,14,9407000000,VALMALA
9,408,42,27,15,9408000000,VALLARTA DE BUREBA
9,409,124,62,62,9409000000,VALLE DE MANZANEDO
9,410,4096,2067,2029,9410000000,VALLE DE MENA
9,411,164,95,69,9411000000,VALLE DE OCA
9,412,879,479,400,9412000000,VALLE DE TOBALINA
9,413,469,255,214,9413000000,VALLE DE VALDEBEZANA
9,414,196,120,76,9414000000,VALLE DE VALDELAGUNA
9,415,326,183,143,9415000000,VALLE DE VALDELUCIO
9,416,49,32,17,9416000000,VALLE DE ZAMANZAS
9,417,41,24,17,9417000000,VALLEJERA
9,418,79,41,38,9418000000,VALLES DE PALENZUELA
9,419,68,46,22,9419000000,VALLUÉRCANES
9,421,262,152,110,9421000000,LA VID Y BARRIOS (LA)
9,422,24,13,11,9422000000,LA VID DE BUREBA (LA)
9,423,26,16,10,9423000000,VILEÑA
9,424,37,23,14,9424000000,VILORIA DE RIOJA
9,425,508,284,224,9425000000,VILVIESTRE DEL PINAR
9,427,1468,805,663,9427000000,VILLADIEGO
9,428,99,50,49,9428000000,VILLAESCUSA DE ROA
9,429,54,37,17,9429000000,VILLAESCUSA LA SOMBRÍA
9,430,26,16,10,9430000000,VILLAESPASA
9,431,117,71,46,9431000000,VILLAFRANCA MONTES DE OCA
9,432,146,87,59,9432000000,VILLAFRUELA
9,433,56,33,23,9433000000,VILLAGALIJO
9,434,1862,980,882,9434000000,VILLAGONZALO PEDERNALES
9,437,310,167,143,9437000000,VILLAHOZ
9,438,698,369,329,9438000000,VILLALBA DE DUERO
9,439,1495,795,700,9439000000,VILLALBILLA DE BURGOS
9,440,89,57,32,9440000000,VILLALBILLA DE GUMIEL
9,441,90,53,37,9441000000,VILLALDEMIRO
9,442,424,224,200,9442000000,VILLALMANZO
9,443,163,81,82,9443000000,VILLAMAYOR DE LOS MONTES
9,444,59,31,28,9444000000,VILLAMAYOR DE TREVIÑO
9,445,45,35,10,9445000000,VILLAMBISTIA
9,446,9,6,3,9446000000,VILLAMEDIANILLA
9,447,42,25,17,9447000000,VILLAMIEL DE LA SIERRA
9,448,225,138,87,9448000000,VILLANGÓMEZ
9,449,121,70,51,9449000000,VILLANUEVA DE ARGAÑO
9,450,27,17,10,9450000000,VILLANUEVA DE CARAZO
9,451,284,144,140,9451000000,VILLANUEVA DE GUMIEL
9,454,43,28,15,9454000000,VILLANUEVA DE TEBA
9,455,44,27,17,9455000000,VILLAQUIRÁN DE LA PUEBLA
9,456,148,79,69,9456000000,VILLAQUIRÁN DE LOS INFANTES
9,458,719,393,326,9458000000,VILLARIEZO
9,460,177,99,78,9460000000,VILLASANDINO
9,463,274,161,113,9463000000,VILLASUR DE HERREROS
9,464,53,29,24,9464000000,VILLATUELDA
9,466,114,67,47,9466000000,VILLAVERDE DEL MONTE
9,467,74,51,23,9467000000,VILLAVERDE-MOGINA
9,471,213,112,101,9471000000,VILLAYERNO MORQUILLAS
9,472,52,30,22,9472000000,VILLAZOPEQUE
9,473,84,44,40,9473000000,VILLEGAS
9,476,69,46,23,9476000000,VILLORUEBO
9,478,47,36,11,9478000000,VIZCAÍNOS
9,480,116,58,58,9480000000,ZAEL
9,482,31,20,11,9482000000,ZARZOSA DE RÍO PISUERGA
9,483,206,105,101,9483000000,ZAZUAR
9,485,57,30,27,9485000000,ZUÑEDA
9,901,346,189,157,9901000000,QUINTANILLA DEL AGUA Y TORDUELES
9,902,487,286,201,9902000000,VALLE DE SANTIBÁÑEZ
9,903,4018,2047,1971,9903000000,VILLARCAYO DE MERINDAD DE CASTILLA LA VIEJA
9,904,544,317,227,9904000000,VALLE DE LAS NAVAS
9,905,428,241,187,9905000000,VALLE DE SEDANO
9,906,1430,802,628,9906000000,MERINDAD DE RÍO UBIERNA
9,907,2180,1148,1032,9907000000,ALFOZ DE QUINTANADUEÑAS
9,908,501,283,218,9908000000,VALLE DE LOSA
10,001,338,185,153,10001000000,ABADÍA
10,002,377,190,187,10002000000,ABERTURA
10,003,582,285,297,10003000000,ACEBO
10,004,802,406,396,10004000000,ACEHÚCHE
10,005,581,299,282,10005000000,ACEITUNA
10,006,1361,680,681,10006000000,AHIGAL
10,007,657,342,315,10007000000,ALBALÁ
10,008,1348,672,676,10008000000,ALCÁNTARA
10,009,255,131,124,10009000000,ALCOLLARÍN
10,010,2459,1277,1182,10010000000,ALCUÉSCAR
10,011,597,324,273,10011000000,ALDEACENTENERA
10,012,606,298,308,10012000000,ALDEA DEL CANO
10,013,297,160,137,10013000000,LA ALDEA DEL OBISPO (LA)
10,014,2015,984,1031,10014000000,ALDEANUEVA DE LA VERA
10,015,725,361,364,10015000000,ALDEANUEVA DEL CAMINO
10,016,362,185,177,10016000000,ALDEHUELA DE JERTE
10,017,755,389,366,10017000000,ALÍA
10,018,1710,874,836,10018000000,ALISEDA
10,019,1647,836,811,10019000000,ALMARAZ
10,020,1799,892,907,10020000000,ALMOHARÍN
10,021,5565,2747,2818,10021000000,ARROYO DE LA LUZ
10,022,425,214,211,10022000000,ARROYOMOLINOS DE LA VERA
10,023,809,413,396,10023000000,ARROYOMOLINOS
10,024,735,341,394,10024000000,BAÑOS DE MONTEMAYOR
10,025,373,193,180,10025000000,BARRADO
10,026,721,372,349,10026000000,BELVÍS DE MONROY
10,027,86,47,39,10027000000,BENQUERENCIA
10,028,120,63,57,10028000000,BERROCALEJO
10,029,396,205,191,10029000000,BERZOCANA
10,030,488,238,250,10030000000,BOHONAL DE IBOR
10,031,185,97,88,10031000000,BOTIJA
10,032,1734,859,875,10032000000,BROZAS
10,033,400,209,191,10033000000,CABAÑAS DEL CASTILLO
10,034,344,176,168,10034000000,CABEZABELLOSA
10,035,2149,1084,1065,10035000000,CABEZUELA DEL VALLE
10,036,341,189,152,10036000000,CABRERO
10,037,96215,45996,50219,10037000000,CÁCERES
10,038,92,46,46,10038000000,CACHORRILLA
10,039,419,212,207,10039000000,CADALSO
10,040,459,236,223,10040000000,CALZADILLA
10,041,1132,596,536,10041000000,CAMINOMORISCO
10,042,83,39,44,10042000000,CAMPILLO DE DELEITOSA
10,043,833,413,420,10043000000,CAMPO LUGAR
10,044,1615,848,767,10044000000,CAÑAMERO
10,045,1009,506,503,10045000000,CAÑAVERAL
10,046,179,90,89,10046000000,CARBAJO
10,047,1078,549,529,10047000000,CARCABOSO
10,048,230,119,111,10048000000,CARRASCALEJO
10,049,4431,2188,2243,10049000000,CASAR DE CÁCERES
10,050,1017,524,493,10050000000,CASAR DE PALOMERO
10,051,404,214,190,10051000000,CASARES DE LAS HURDES
10,052,191,102,89,10052000000,CASAS DE DON ANTONIO
10,053,321,176,145,10053000000,CASAS DE DON GÓMEZ
10,054,579,290,289,10054000000,CASAS DEL CASTAÑAR
10,055,769,394,375,10055000000,CASAS DEL MONTE
10,056,549,278,271,10056000000,CASAS DE MILLÁN
10,057,114,75,39,10057000000,CASAS DE MIRAVETE
10,058,1360,711,649,10058000000,CASATEJADA
10,059,343,171,172,10059000000,CASILLAS DE CORIA
10,060,1013,523,490,10060000000,CASTAÑAR DE IBOR
10,061,1780,902,878,10061000000,CECLAVÍN
10,062,433,221,212,10062000000,CEDILLO
10,063,144,70,74,10063000000,CEREZO
10,064,1562,792,770,10064000000,CILLEROS
10,065,261,136,125,10065000000,COLLADO DE LA VERA
10,066,190,111,79,10066000000,CONQUISTA DE LA SIERRA
10,067,12166,5962,6204,10067000000,CORIA
10,068,833,425,408,10068000000,CUACOS DE YUSTE
10,069,840,426,414,10069000000,LA CUMBRE (LA)
10,070,685,347,338,10070000000,DELEITOSA
10,071,103,58,45,10071000000,DESCARGAMARÍA
10,072,865,442,423,10072000000,ELJAS
10,073,863,457,406,10073000000,ESCURIAL
10,075,241,129,112,10075000000,FRESNEDOSO DE IBOR
10,076,858,424,434,10076000000,GALISTEO
10,077,687,353,334,10077000000,GARCIAZ
10,078,353,186,167,10078000000,LA GARGANTA (LA)
10,079,898,469,429,10079000000,GARGANTA LA OLLA
10,080,371,192,179,10080000000,GARGANTILLA
10,081,176,93,83,10081000000,GARGÜERA
10,082,1974,964,1010,10082000000,GARROVILLAS DE ALCONÉTAR
10,083,99,55,44,10083000000,GARVÍN
10,084,1372,700,672,10084000000,GATA
10,085,364,196,168,10085000000,EL GORDO (EL)
10,086,316,164,152,10086000000,LA GRANJA (LA)
10,087,1787,888,899,10087000000,GUADALUPE
10,088,195,107,88,10088000000,GUIJO DE CORIA
10,089,1509,758,751,10089000000,GUIJO DE GALISTEO
10,090,493,257,236,10090000000,GUIJO DE GRANADILLA
10,091,378,201,177,10091000000,GUIJO DE SANTA BÁRBARA
10,092,266,140,126,10092000000,HERGUIJUELA
10,093,416,205,211,10093000000,HERNÁN-PÉREZ
10,094,228,126,102,10094000000,HERRERA DE ALCÁNTARA
10,095,321,165,156,10095000000,HERRERUELA
10,096,3907,1916,1991,10096000000,HERVÁS
10,097,105,59,46,10097000000,HIGUERA DE ALBALAT
10,098,391,197,194,10098000000,HINOJAL
10,099,607,303,304,10099000000,HOLGUERA
10,100,851,422,429,10100000000,HOYOS
10,101,210,101,109,10101000000,HUÉLAGA
10,102,531,266,265,10102000000,IBAHERNANDO
10,103,444,213,231,10103000000,JARAICEJO
10,104,6664,3349,3315,10104000000,JARAÍZ DE LA VERA
10,105,2845,1407,1438,10105000000,JARANDILLA DE LA VERA
10,106,139,72,67,10106000000,JARILLA
10,107,1238,616,622,10107000000,JERTE
10,108,191,113,78,10108000000,LADRILLAR
10,109,1913,983,930,10109000000,LOGROSÁN
10,110,2718,1367,1351,10110000000,LOSAR DE LA VERA
10,111,1542,809,733,10111000000,MADRIGAL DE LA VERA
10,112,1712,861,851,10112000000,MADRIGALEJO
10,113,2357,1177,1180,10113000000,MADROÑERA
10,114,1293,649,644,10114000000,MAJADAS
10,115,4086,2040,2046,10115000000,MALPARTIDA DE CÁCERES
10,116,4618,2282,2336,10116000000,MALPARTIDA DE PLASENCIA
10,117,241,132,109,10117000000,MARCHAGAZ
10,118,284,146,138,10118000000,MATA DE ALCÁNTARA
10,119,572,284,288,10119000000,MEMBRÍO
10,120,150,76,74,10120000000,MESAS DE IBOR
10,121,9359,4653,4706,10121000000,MIAJADAS
10,122,233,119,114,10122000000,MILLANES
10,123,650,328,322,10123000000,MIRABEL
10,124,834,417,417,10124000000,MOHEDAS DE GRANADILLA
10,125,899,465,434,10125000000,MONROY
10,126,1598,801,797,10126000000,MONTÁNCHEZ
10,127,5619,2860,2759,10127000000,MONTEHERMOSO
10,128,6585,3268,3317,10128000000,MORALEJA
10,129,358,172,186,10129000000,MORCILLO
10,130,2065,1043,1022,10130000000,NAVACONCEJO
10,131,16895,8162,8733,10131000000,NAVALMORAL DE LA MATA
10,132,383,196,187,10132000000,NAVALVILLAR DE IBOR
10,133,1243,612,631,10133000000,NAVAS DEL MADROÑO
10,134,648,333,315,10134000000,NAVEZUELAS
10,135,1225,660,565,10135000000,NUÑOMORAL
10,136,299,173,126,10136000000,OLIVA DE PLASENCIA
10,137,406,212,194,10137000000,PALOMERO
10,138,580,282,298,10138000000,PASARÓN DE LA VERA
10,139,90,52,38,10139000000,PEDROSO DE ACIM
10,140,1409,706,703,10140000000,PERALEDA DE LA MATA
10,141,298,173,125,10141000000,PERALEDA DE SAN ROMÁN
10,142,911,461,450,10142000000,PERALES DEL PUERTO
10,143,137,60,77,10143000000,PESCUEZA
10,144,976,508,468,10144000000,LA PESGA (LA)
10,145,130,63,67,10145000000,PIEDRAS ALBAS
10,146,1749,918,831,10146000000,PINOFRANQUEADO
10,147,1470,751,719,10147000000,PIORNAL
10,148,39412,18898,20514,10148000000,PLASENCIA
10,149,498,240,258,10149000000,PLASENZUELA
10,150,373,183,190,10150000000,PORTAJE
10,151,216,115,101,10151000000,PORTEZUELO
10,152,444,221,223,10152000000,POZUELO DE ZARZÓN
10,153,267,137,130,10153000000,PUERTO DE SANTA CRUZ
10,154,200,105,95,10154000000,REBOLLAR
10,155,1190,582,608,10155000000,RIOLOBOS
10,156,86,50,36,10156000000,ROBLEDILLO DE GATA
10,157,263,133,130,10157000000,ROBLEDILLO DE LA VERA
10,158,356,183,173,10158000000,ROBLEDILLO DE TRUJILLO
10,159,312,172,140,10159000000,ROBLEDOLLANO
10,160,246,119,127,10160000000,ROMANGORDO
10,161,75,42,33,10161000000,RUANES
10,162,538,282,256,10162000000,SALORINO
10,163,257,132,125,10163000000,SALVATIERRA DE SANTIAGO
10,164,723,350,373,10164000000,SAN MARTÍN DE TREVEJO
10,165,301,153,148,10165000000,SANTA ANA
10,166,319,163,156,10166000000,SANTA CRUZ DE LA SIERRA
10,167,280,159,121,10167000000,SANTA CRUZ DE PANIAGUA
10,168,284,146,138,10168000000,SANTA MARTA DE MAGASCA
10,169,475,230,245,10169000000,SANTIAGO DE ALCÁNTARA
10,170,245,124,121,10170000000,SANTIAGO DEL CAMPO
10,171,361,192,169,10171000000,SANTIBÁÑEZ EL ALTO
10,172,713,372,341,10172000000,SANTIBÁÑEZ EL BAJO
10,173,947,495,452,10173000000,SAUCEDILLA
10,174,181,96,85,10174000000,SEGURA DE TORO
10,175,1493,749,744,10175000000,SERRADILLA
10,176,405,206,199,10176000000,SERREJÓN
10,177,2020,1036,984,10177000000,SIERRA DE FUENTES
10,178,776,404,372,10178000000,TALAVÁN
10,179,302,155,147,10179000000,TALAVERUELA DE LA VERA
10,180,7273,3852,3421,10180000000,TALAYUELA
10,181,763,402,361,10181000000,TEJEDA DE TIÉTAR
10,182,164,103,61,10182000000,TORIL
10,183,985,522,463,10183000000,TORNAVACAS
10,184,838,438,400,10184000000,EL TORNO (EL)
10,185,662,345,317,10185000000,TORRECILLA DE LOS ÁNGELES
10,186,1050,533,517,10186000000,TORRECILLAS DE LA TIESA
10,187,483,250,233,10187000000,TORRE DE DON MIGUEL
10,188,529,263,266,10188000000,TORRE DE SANTA MARÍA
10,189,2819,1369,1450,10189000000,TORREJONCILLO
10,190,519,263,256,10190000000,TORREJÓN EL RUBIO
10,191,611,316,295,10191000000,TORREMENGA
10,192,739,375,364,10192000000,TORREMOCHA
10,193,1682,839,843,10193000000,TORREORGAZ
10,194,567,278,289,10194000000,TORREQUEMADA
10,195,8605,4192,4413,10195000000,TRUJILLO
10,196,311,158,153,10196000000,VALDASTILLAS
10,197,109,56,53,10197000000,VALDECAÑAS DE TAJO
10,198,1104,531,573,10198000000,VALDEFUENTES
10,199,194,105,89,10199000000,VALDEHÚNCAR
10,200,339,178,161,10200000000,VALDELACASA DE TAJO
10,201,215,106,109,10201000000,VALDEMORALES
10,202,636,313,323,10202000000,VALDEOBISPO
10,203,5236,2571,2665,10203000000,VALENCIA DE ALCÁNTARA
10,204,467,232,235,10204000000,VALVERDE DE LA VERA
10,205,2106,1061,1045,10205000000,VALVERDE DEL FRESNO
10,206,225,115,110,10206000000,VIANDAR DE LA VERA
10,207,438,212,226,10207000000,VILLA DEL CAMPO
10,208,116,58,58,10208000000,VILLA DEL REY
10,209,276,142,134,10209000000,VILLAMESÍAS
10,210,379,190,189,10210000000,VILLAMIEL
10,211,496,252,244,10211000000,VILLANUEVA DE LA SIERRA
10,212,2087,1046,1041,10212000000,VILLANUEVA DE LA VERA
10,213,548,279,269,10213000000,VILLAR DEL PEDROSO
10,214,230,120,110,10214000000,VILLAR DE PLASENCIA
10,215,383,188,195,10215000000,VILLASBUENAS DE GATA
10,216,1799,916,883,10216000000,ZARZA DE GRANADILLA
10,217,515,265,250,10217000000,ZARZA DE MONTÁNCHEZ
10,218,1134,568,566,10218000000,ZARZA LA MAYOR
10,219,1267,626,641,10219000000,ZORITA
10,901,1326,680,646,10901000000,ROSALEJO
10,902,848,436,412,10902000000,VEGAVIANA
10,903,913,450,463,10903000000,ALAGÓN DEL RÍO
10,904,844,456,388,10904000000,TIÉTAR
10,905,782,385,397,10905000000,PUEBLONUEVO DE MIRAMONTES
11,001,5205,2672,2533,11001000000,ALCALÁ DE LOS GAZULES
11,002,4995,2497,2498,11002000000,ALCALÁ DEL VALLE
11,003,1444,739,705,11003000000,ALGAR
11,004,123639,60849,62790,11004000000,ALGECIRAS
11,005,5498,2780,2718,11005000000,ALGODONALES
11,006,30953,15432,15521,11006000000,ARCOS DE LA FRONTERA
11,007,22811,11374,11437,11007000000,BARBATE
11,008,24219,12137,12082,11008000000,LOS BARRIOS (LOS)
11,009,714,386,328,11009000000,BENAOCAZ
11,010,7559,3771,3788,11010000000,BORNOS
11,011,2224,1117,1107,11011000000,EL BOSQUE (EL)
11,012,111811,52724,59087,11012000000,CÁDIZ
11,013,3020,1490,1530,11013000000,CASTELLAR DE LA FRONTERA
11,014,23661,11852,11809,11014000000,CONIL DE LA FRONTERA
11,015,88709,44267,44442,11015000000,CHICLANA DE LA FRONTERA
11,016,19649,9813,9836,11016000000,CHIPIONA
11,017,3802,1897,1905,11017000000,ESPERA
11,018,1697,864,833,11018000000,EL GASTOR (EL)
11,019,2002,992,1010,11019000000,GRAZALEMA
11,020,213231,104044,109187,11020000000,JEREZ DE LA FRONTERA
11,021,6675,3396,3279,11021000000,JIMENA DE LA FRONTERA
11,022,63773,31283,32490,11022000000,LA LÍNEA DE LA CONCEPCIÓN (LA)
11,023,11738,5905,5833,11023000000,MEDINA SIDONIA
11,024,7887,3881,4006,11024000000,OLVERA
11,025,5441,2816,2625,11025000000,PATERNA DE RIVERA
11,026,5634,2763,2871,11026000000,PRADO DEL REY
11,027,89813,43850,45963,11027000000,EL PUERTO DE SANTA MARÍA (EL)
11,028,42069,21131,20938,11028000000,PUERTO REAL
11,029,6929,3516,3413,11029000000,PUERTO SERRANO
11,030,29675,14714,14961,11030000000,ROTA
11,031,93927,45720,48207,11031000000,SAN FERNANDO
11,032,69805,34770,35035,11032000000,SANLÚCAR DE BARRAMEDA
11,033,33646,16742,16904,11033000000,SAN ROQUE
11,034,2638,1365,1273,11034000000,SETENIL DE LAS BODEGAS
11,035,18621,9323,9298,11035000000,TARIFA
11,036,799,404,395,11036000000,TORRE ALHÁQUIME
11,037,7000,3476,3524,11037000000,TREBUJENA
11,038,16363,8056,8307,11038000000,UBRIQUE
11,039,12864,6408,6456,11039000000,VEJER DE LA FRONTERA
11,040,480,241,239,11040000000,VILLALUENGA DEL ROSARIO
11,041,12165,6126,6039,11041000000,VILLAMARTÍN
11,042,1362,688,674,11042000000,ZAHARA
11,901,7164,3636,3528,11901000000,BENALUP-CASAS VIEJAS
11,902,4486,2277,2209,11902000000,SAN JOSÉ DEL VALLE
11,903,2742,1414,1328,11903000000,SAN MARTÍN DEL TESORILLO
12,001,1319,671,648,12001000000,ATZENETA DEL MAESTRAT
12,002,130,71,59,12002000000,AÍN
12,003,1302,655,647,12003000000,ALBOCÀSSER
12,004,7160,3620,3540,12004000000,ALCALÀ DE XIVERT
12,005,10526,5268,5258,12005000000,L'ALCORA (L')
12,006,203,109,94,12006000000,ALCUDIA DE VEO
12,007,873,434,439,12007000000,ALFONDEGUILLA
12,008,249,137,112,12008000000,ALGIMIA DE ALMONACID
12,009,27989,14011,13978,12009000000,ALMASSORA
12,010,280,155,125,12010000000,ALMEDÍJAR
12,011,6591,3302,3289,12011000000,ALMENARA
12,012,3695,1912,1783,12012000000,ALTURA
12,013,165,91,74,12013000000,ARAÑUEL
12,014,174,104,70,12014000000,ARES DEL MAESTRAT
12,015,156,84,72,12015000000,ARGELITA
12,016,1980,1010,970,12016000000,ARTANA
12,017,178,96,82,12017000000,AYÓDAR
12,018,336,183,153,12018000000,AZUÉBAR
12,020,198,103,95,12020000000,BARRACAS
12,021,5580,2760,2820,12021000000,BETXÍ
12,022,409,241,168,12022000000,BEJÍS
12,024,164,82,82,12024000000,BENAFER
12,025,135,78,57,12025000000,BENAFIGOS
12,026,1026,527,499,12026000000,BENASSAL
12,027,28681,14432,14249,12027000000,BENICARLÓ
12,028,19951,9808,10143,12028000000,BENICÀSSIM/BENICASIM
12,029,1108,562,546,12029000000,BENLLOC
12,031,5865,3004,2861,12031000000,BORRIOL
12,032,35750,17769,17981,12032000000,BORRIANA/BURRIANA
12,033,3222,1651,1571,12033000000,CABANES
12,034,2013,1013,1000,12034000000,CÀLIG
12,036,685,352,333,12036000000,CANET LO ROIG
12,037,19,11,8,12037000000,CASTELL DE CABRES
12,038,188,98,90,12038000000,CASTELLFORT
12,039,888,456,432,12039000000,CASTELLNOVO
12,040,176238,85021,91217,12040000000,CASTELLÓ DE LA PLANA
12,041,109,72,37,12041000000,CASTILLO DE VILLAMALEFA
12,042,724,361,363,12042000000,CATÍ
12,043,716,358,358,12043000000,CAUDIEL
12,044,656,317,339,12044000000,CERVERA DEL MAESTRE
12,045,427,207,220,12045000000,CINCTORRES
12,046,223,127,96,12046000000,CIRAT
12,048,304,156,148,12048000000,CORTES DE ARENOSO
12,049,535,282,253,12049000000,COSTUR
12,050,1831,934,897,12050000000,LES COVES DE VINROMÀ (LES)
12,051,480,247,233,12051000000,CULLA
12,052,686,342,344,12052000000,XERT
12,053,2981,1531,1450,12053000000,CHILCHES/XILXES
12,055,117,72,45,12055000000,XODOS/CHODOS
12,056,310,161,149,12056000000,CHÓVAR
12,057,758,383,375,12057000000,ESLIDA
12,058,90,50,40,12058000000,ESPADILLA
12,059,294,154,140,12059000000,FANZARA
12,060,518,258,260,12060000000,FIGUEROLES
12,061,473,227,246,12061000000,FORCALL
12,063,59,31,28,12063000000,FUENTE LA REINA
12,064,98,55,43,12064000000,FUENTES DE AYÓDAR
12,065,197,109,88,12065000000,GAIBIEL
12,067,650,325,325,12067000000,GELDO
12,068,62,39,23,12068000000,HERBERS
12,069,50,24,26,12069000000,HIGUERAS
12,070,678,348,330,12070000000,LA JANA (LA)
12,071,1794,895,899,12071000000,JÉRICA
12,072,1369,683,686,12072000000,LLUCENA/LUCENA DEL CID
12,073,155,88,67,12073000000,LUDIENTE
12,074,1003,489,514,12074000000,LA LLOSA (LA)
12,075,179,96,83,12075000000,LA MATA DE MORELLA (LA)
12,076,84,52,32,12076000000,MATET
12,077,7747,3946,3801,12077000000,MONCOFA
12,078,399,199,200,12078000000,MONTÁN
12,079,603,313,290,12079000000,MONTANEJOS
12,080,2492,1223,1269,12080000000,MORELLA
12,081,840,431,409,12081000000,NAVAJAS
12,082,13827,6938,6889,12082000000,NULES
12,083,126,66,60,12083000000,OLOCAU DEL REY
12,084,25547,12795,12752,12084000000,ONDA
12,085,10958,5596,5362,12085000000,ORPESA/OROPESA DEL MAR
12,087,36,21,15,12087000000,PALANQUES
12,088,74,45,29,12088000000,PAVÍAS
12,089,8449,4303,4146,12089000000,PENÍSCOLA/PEÑÍSCOLA
12,090,119,65,54,12090000000,PINA DE MONTALGRAO
12,091,166,85,81,12091000000,PORTELL DE MORELLA
12,092,169,95,74,12092000000,PUEBLA DE ARENOSO
12,093,235,135,100,12093000000,LA POBLA DE BENIFASSÀ (LA)
12,094,1309,670,639,12094000000,LA POBLA TORNESA (LA)
12,095,1135,584,551,12095000000,RIBESALBES
12,096,891,467,424,12096000000,ROSSELL
12,097,86,53,33,12097000000,SACAÑET
12,098,660,346,314,12098000000,LA SALZADELLA (LA)
12,099,1249,654,595,12099000000,SANT JORDI/SAN JORGE
12,100,1987,979,1008,12100000000,SANT MATEU
12,101,494,246,248,12101000000,SAN RAFAEL DEL RÍO
12,102,784,411,373,12102000000,SANTA MAGDALENA DE PULPIS
12,103,110,51,59,12103000000,LA SERRATELLA (LA)
12,104,9425,4648,4777,12104000000,SEGORBE
12,105,1045,549,496,12105000000,SIERRA ENGARCERÁN
12,106,1508,744,764,12106000000,SONEJA
12,107,474,256,218,12107000000,SOT DE FERRER
12,108,572,296,276,12108000000,SUERA/SUERAS
12,109,852,435,417,12109000000,TALES
12,110,250,137,113,12110000000,TERESA
12,111,430,217,213,12111000000,TÍRIG
12,112,144,86,58,12112000000,TODOLELLA
12,113,112,60,52,12113000000,TOGA
12,114,256,137,119,12114000000,TORÁS
12,115,248,128,120,12115000000,EL TORO (EL)
12,116,69,34,35,12116000000,TORRALBA DEL PINAR
12,117,5630,2862,2768,12117000000,TORREBLANCA
12,118,114,58,56,12118000000,TORRECHIVA
12,119,164,88,76,12119000000,LA TORRE D'EN BESORA (LA)
12,120,175,94,81,12120000000,LA TORRE D'EN DOMÉNEC (LA)
12,121,1336,681,655,12121000000,TRAIGUERA
12,122,985,511,474,12122000000,LES USERES (LES)/USERAS
12,123,66,31,35,12123000000,VALLAT
12,124,3054,1596,1458,12124000000,VALL D'ALBA
12,125,286,149,137,12125000000,VALL DE ALMONACID
12,126,31611,15488,16123,12126000000,LA VALL D'UIXÓ (LA)
12,127,62,38,24,12127000000,VALLIBONA
12,128,1915,1026,889,12128000000,VILAFAMÉS
12,129,2148,1089,1059,12129000000,VILAFRANCA/VILLAFRANCA DEL CID
12,130,488,265,223,12130000000,VILLAHERMOSA DEL RÍO
12,131,95,58,37,12131000000,VILLAMALUR
12,132,575,304,271,12132000000,VILANOVA D'ALCOLEA
12,133,110,61,49,12133000000,VILLANUEVA DE VIVER
12,134,159,79,80,12134000000,VILAR DE CANES
12,135,51852,25739,26113,12135000000,VILA-REAL
12,136,3074,1526,1548,12136000000,LA VILAVELLA (LA)
12,137,54,26,28,12137000000,VILLORES
12,138,29686,14598,15088,12138000000,VINARÒS
12,139,369,197,172,12139000000,VISTABELLA DEL MAESTRAT
12,140,1683,873,810,12140000000,VIVER
12,141,117,58,59,12141000000,ZORITA DEL MAESTRAZGO
12,142,176,98,78,12142000000,ZUCAINA
12,901,4539,2281,2258,12901000000,LES ALQUERIES (LES)/ALQUERÍAS DEL NIÑO PERDIDO
12,902,3516,1803,1713,12902000000,SANT JOAN DE MORÓ
13,001,1328,686,642,13001000000,ABENÓJAR
13,002,1611,813,798,13002000000,AGUDO
13,003,469,241,228,13003000000,ALAMILLO
13,004,1046,551,495,13004000000,ALBALADEJO
13,005,30928,15036,15892,13005000000,ALCÁZAR DE SAN JUAN
13,006,551,279,272,13006000000,ALCOBA
13,007,1382,697,685,13007000000,ALCOLEA DE CALATRAVA
13,008,445,220,225,13008000000,ALCUBILLAS
13,009,1573,787,786,13009000000,ALDEA DEL REY
13,010,967,491,476,13010000000,ALHAMBRA
13,011,4968,2405,2563,13011000000,ALMADÉN
13,012,397,203,194,13012000000,ALMADENEJOS
13,013,8958,4433,4525,13013000000,ALMAGRO
13,014,485,262,223,13014000000,ALMEDINA
13,015,5788,2907,2881,13015000000,ALMODÓVAR DEL CAMPO
13,016,746,374,372,13016000000,ALMURADIEL
13,017,268,142,126,13017000000,ANCHURAS
13,018,1022,521,501,13018000000,ARENAS DE SAN JUAN
13,019,6888,3468,3420,13019000000,ARGAMASILLA DE ALBA
13,020,5801,2904,2897,13020000000,ARGAMASILLA DE CALATRAVA
13,021,415,224,191,13021000000,ARROBA DE LOS MONTES
13,022,371,189,182,13022000000,BALLESTEROS DE CALATRAVA
13,023,11991,6187,5804,13023000000,BOLAÑOS DE CALATRAVA
13,024,1007,535,472,13024000000,BRAZATORTAS
13,025,303,164,139,13025000000,CABEZARADOS
13,026,494,257,237,13026000000,CABEZARRUBIAS DEL PUERTO
13,027,3779,1892,1887,13027000000,CALZADA DE CALATRAVA
13,028,12960,6499,6461,13028000000,CAMPO DE CRIPTANA
13,029,101,59,42,13029000000,CAÑADA DE CALATRAVA
13,030,137,82,55,13030000000,CARACUEL DE CALATRAVA
13,031,3184,1617,1567,13031000000,CARRIÓN DE CALATRAVA
13,032,1137,569,568,13032000000,CARRIZOSA
13,033,1803,917,886,13033000000,CASTELLAR DE SANTIAGO
13,034,75303,35660,39643,13034000000,CIUDAD REAL
13,035,1113,541,572,13035000000,CORRAL DE CALATRAVA
13,036,857,457,400,13036000000,LOS CORTIJOS (LOS)
13,037,933,482,451,13037000000,CÓZAR
13,038,1772,851,921,13038000000,CHILLÓN
13,039,17629,8871,8758,13039000000,DAIMIEL
13,040,984,495,489,13040000000,FERNÁN CABALLERO
13,041,237,134,103,13041000000,FONTANAREJO
13,042,1008,529,479,13042000000,FUENCALIENTE
13,043,204,111,93,13043000000,FUENLLANA
13,044,3072,1584,1488,13044000000,FUENTE EL FRESNO
13,045,696,340,356,13045000000,GRANÁTULA DE CALATRAVA
13,046,715,349,366,13046000000,GUADALMEZ
13,047,8385,4270,4115,13047000000,HERENCIA
13,048,497,259,238,13048000000,HINOJOSAS DE CALATRAVA
13,049,789,405,384,13049000000,HORCAJO DE LOS MONTES
13,050,546,291,255,13050000000,LAS LABORES (LAS)
13,051,371,197,174,13051000000,LUCIANA
13,052,7745,3859,3886,13052000000,MALAGÓN
13,053,17732,8806,8926,13053000000,MANZANARES
13,054,5825,2906,2919,13054000000,MEMBRILLA
13,055,663,347,316,13055000000,MESTANZA
13,056,15769,7934,7835,13056000000,MIGUELTURRA
13,057,1225,642,583,13057000000,MONTIEL
13,058,5109,2581,2528,13058000000,MORAL DE CALATRAVA
13,059,207,106,101,13059000000,NAVALPINO
13,060,286,151,135,13060000000,NAVAS DE ESTENA
13,061,7480,3796,3684,13061000000,PEDRO MUÑOZ
13,062,679,355,324,13062000000,PICÓN
13,063,4352,2213,2139,13063000000,PIEDRABUENA
13,064,2863,1458,1405,13064000000,POBLETE
13,065,3509,1817,1692,13065000000,PORZUNA
13,066,3709,1902,1807,13066000000,POZUELO DE CALATRAVA
13,067,368,188,180,13067000000,LOS POZUELOS DE CALATRAVA (LOS)
13,068,1108,615,493,13068000000,PUEBLA DE DON RODRIGO
13,069,658,345,313,13069000000,PUEBLA DEL PRÍNCIPE
13,070,883,438,445,13070000000,PUERTO LÁPICE
13,071,45127,21706,23421,13071000000,PUERTOLLANO
13,072,880,482,398,13072000000,RETUERTA DEL BULLAQUE
13,073,530,277,253,13073000000,SACERUELA
13,074,1082,556,526,13074000000,SAN CARLOS DEL VALLE
13,075,199,110,89,13075000000,SAN LORENZO DE CALATRAVA
13,076,491,234,257,13076000000,SANTA CRUZ DE LOS CÁÑAMOS
13,077,3872,1931,1941,13077000000,SANTA CRUZ DE MUDELA
13,078,12123,6118,6005,13078000000,SOCUÉLLAMOS
13,079,15242,7787,7455,13079000000,LA SOLANA (LA)
13,080,329,171,158,13080000000,SOLANA DEL PINO
13,081,600,313,287,13081000000,TERRINCHES
13,082,36304,18142,18162,13082000000,TOMELLOSO
13,083,3057,1517,1540,13083000000,TORRALBA DE CALATRAVA
13,084,970,477,493,13084000000,TORRE DE JUAN ABAD
13,085,2651,1335,1316,13085000000,TORRENUEVA
13,086,161,87,74,13086000000,VALDEMANCO DEL ESTERAS
13,087,30411,14806,15605,13087000000,VALDEPEÑAS
13,088,654,309,345,13088000000,VALENZUELA DE CALATRAVA
13,089,1718,845,873,13089000000,VILLAHERMOSA
13,090,1084,530,554,13090000000,VILLAMANRIQUE
13,091,638,321,317,13091000000,VILLAMAYOR DE CALATRAVA
13,092,1923,990,933,13092000000,VILLANUEVA DE LA FUENTE
13,093,4775,2385,2390,13093000000,VILLANUEVA DE LOS INFANTES
13,094,277,143,134,13094000000,VILLANUEVA DE SAN CARLOS
13,095,54,31,23,13095000000,VILLAR DEL POZO
13,096,9667,4847,4820,13096000000,VILLARRUBIA DE LOS OJOS
13,097,2710,1364,1346,13097000000,VILLARTA DE SAN JUAN
13,098,2135,1039,1096,13098000000,VISO DEL MARQUÉS
13,901,1061,559,502,13901000000,EL ROBLEDO (EL)
13,902,540,265,275,13902000000,RUIDERA
13,903,597,313,284,13903000000,ARENALES DE SAN GREGORIO
13,904,681,332,349,13904000000,LLANOS DEL CAUDILLO
14,001,4092,2082,2010,14001000000,ADAMUZ
14,002,13282,6602,6680,14002000000,AGUILAR DE LA FRONTERA
14,003,1493,728,765,14003000000,ALCARACEJOS
14,004,2340,1163,1177,14004000000,ALMEDINILLA
14,005,7995,4015,3980,14005000000,ALMODÓVAR DEL RÍO
14,006,1507,745,762,14006000000,AÑORA
14,007,18533,9278,9255,14007000000,BAENA
14,008,3138,1545,1593,14008000000,BELALCÁZAR
14,009,2802,1351,1451,14009000000,BELMEZ
14,010,4979,2454,2525,14010000000,BENAMEJÍ
14,011,643,326,317,14011000000,LOS BLÁZQUEZ (LOS)
14,012,7186,3591,3595,14012000000,BUJALANCE
14,013,20070,9758,10312,14013000000,CABRA
14,014,2829,1449,1380,14014000000,CAÑETE DE LAS TORRES
14,015,2318,1182,1136,14015000000,CARCABUEY
14,016,1437,725,712,14016000000,CARDEÑA
14,017,14258,7087,7171,14017000000,LA CARLOTA (LA)
14,018,4327,2135,2192,14018000000,EL CARPIO (EL)
14,019,7665,3774,3891,14019000000,CASTRO DEL RÍO
14,020,371,187,184,14020000000,CONQUISTA
14,021,323763,155314,168449,14021000000,CÓRDOBA
14,022,4511,2181,2330,14022000000,DOÑA MENCÍA
14,023,2383,1199,1184,14023000000,DOS TORRES
14,024,2252,1104,1148,14024000000,ENCINAS REALES
14,025,3209,1602,1607,14025000000,ESPEJO
14,026,2386,1205,1181,14026000000,ESPIEL
14,027,9611,4756,4855,14027000000,FERNÁN-NÚÑEZ
14,028,354,179,175,14028000000,FUENTE LA LANCHA
14,029,4415,2290,2125,14029000000,FUENTE OBEJUNA
14,030,9850,4920,4930,14030000000,FUENTE PALMERA
14,031,692,335,357,14031000000,FUENTE-TÓJAR
14,032,410,198,212,14032000000,LA GRANJUELA (LA)
14,033,1533,783,750,14033000000,GUADALCÁZAR
14,034,341,177,164,14034000000,EL GUIJO (EL)
14,035,6579,3243,3336,14035000000,HINOJOSA DEL DUQUE
14,036,4415,2203,2212,14036000000,HORNACHUELOS
14,037,3804,1934,1870,14037000000,IZNÁJAR
14,038,42813,21264,21549,14038000000,LUCENA
14,039,2860,1436,1424,14039000000,LUQUE
14,040,4465,2199,2266,14040000000,MONTALBÁN DE CÓRDOBA
14,041,3872,1960,1912,14041000000,MONTEMAYOR
14,042,22298,11049,11249,14042000000,MONTILLA
14,043,9125,4506,4619,14043000000,MONTORO
14,044,1929,970,959,14044000000,MONTURQUE
14,045,3658,1841,1817,14045000000,MORILES
14,046,5317,2708,2609,14046000000,NUEVA CARTEYA
14,047,2076,1094,982,14047000000,OBEJO
14,048,1441,736,705,14048000000,PALENCIANA
14,049,20688,10243,10445,14049000000,PALMA DEL RÍO
14,050,2775,1400,1375,14050000000,PEDRO ABAD
14,051,1485,734,751,14051000000,PEDROCHE
14,052,10317,4986,5331,14052000000,PEÑARROYA-PUEBLONUEVO
14,053,7256,3598,3658,14053000000,POSADAS
14,054,16946,8235,8711,14054000000,POZOBLANCO
14,055,22003,10708,11295,14055000000,PRIEGO DE CÓRDOBA
14,056,29781,14691,15090,14056000000,PUENTE GENIL
14,057,7473,3732,3741,14057000000,LA RAMBLA (LA)
14,058,9779,4896,4883,14058000000,RUTE
14,059,833,423,410,14059000000,SAN SEBASTIÁN DE LOS BALLESTEROS
14,060,4640,2341,2299,14060000000,SANTAELLA
14,061,710,351,359,14061000000,SANTA EUFEMIA
14,062,1003,494,509,14062000000,TORRECAMPO
14,063,1045,525,520,14063000000,VALENZUELA
14,064,356,173,183,14064000000,VALSEQUILLO
14,065,2312,1148,1164,14065000000,LA VICTORIA (LA)
14,066,6882,3428,3454,14066000000,VILLA DEL RÍO
14,067,4866,2475,2391,14067000000,VILLAFRANCA DE CÓRDOBA
14,068,628,303,325,14068000000,VILLAHARTA
14,069,8460,4194,4266,14069000000,VILLANUEVA DE CÓRDOBA
14,070,1406,710,696,14070000000,VILLANUEVA DEL DUQUE
14,071,1000,487,513,14071000000,VILLANUEVA DEL REY
14,072,1088,550,538,14072000000,VILLARALTO
14,073,3085,1573,1512,14073000000,VILLAVICIOSA DE CÓRDOBA
14,074,2507,1269,1238,14074000000,EL VISO (EL)
14,075,621,318,303,14075000000,ZUHEROS
14,901,1089,559,530,14901000000,FUENTE CARRETEROS
14,902,1336,684,652,14902000000,LA GUIJARROSA (LA)
15,001,5584,2763,2821,15001000000,ABEGONDO
15,002,32482,15617,16865,15002000000,AMES
15,003,1815,924,891,15003000000,ARANGA
15,004,6132,3019,3113,15004000000,ARES
15,005,33516,16539,16977,15005000000,ARTEIXO
15,006,5901,2919,2982,15006000000,ARZÚA
15,007,3332,1577,1755,15007000000,A BAÑA (A)
15,008,6951,3402,3549,15008000000,BERGONDO
15,009,13082,6234,6848,15009000000,BETANZOS
15,010,1849,930,919,15010000000,BOIMORTO
15,011,18984,9200,9784,15011000000,BOIRO
15,012,4146,2025,2121,15012000000,BOQUEIXÓN
15,013,8145,3913,4232,15013000000,BRIÓN
15,014,4123,2001,2122,15014000000,CABANA DE BERGANTIÑOS
15,015,3300,1601,1699,15015000000,CABANAS
15,016,5151,2526,2625,15016000000,CAMARIÑAS
15,017,24739,12060,12679,15017000000,CAMBRE
15,018,1185,582,603,15018000000,A CAPELA (A)
15,019,31416,15329,16087,15019000000,CARBALLO
15,020,3815,1821,1994,15020000000,CARNOTA
15,021,6700,3285,3415,15021000000,CARRAL
15,022,6529,3245,3284,15022000000,CEDEIRA
15,023,7660,3658,4002,15023000000,CEE
15,024,5058,2518,2540,15024000000,CERCEDA
15,025,1033,507,526,15025000000,CERDIDO
15,027,1923,949,974,15027000000,COIRÓS
15,028,1647,829,818,15028000000,CORCUBIÓN
15,029,5779,2773,3006,15029000000,CORISTANCO
15,030,247376,114547,132829,15030000000,A CORUÑA (A)
15,031,30864,14825,16039,15031000000,CULLEREDO
15,032,4135,2096,2039,15032000000,CURTIS
15,033,2659,1264,1395,15033000000,DODRO
15,034,2856,1361,1495,15034000000,DUMBRÍA
15,035,12561,5966,6595,15035000000,FENE
15,036,63890,30082,33808,15036000000,FERROL
15,037,4697,2380,2317,15037000000,FISTERRA
15,038,2246,1116,1130,15038000000,FRADES
15,039,1316,664,652,15039000000,IRIXOA
15,040,2939,1472,1467,15040000000,LAXE
15,041,11543,5688,5855,15041000000,A LARACHA (A)
15,042,3145,1562,1583,15042000000,LOUSAME
15,043,5241,2562,2679,15043000000,MALPICA DE BERGANTIÑOS
15,044,1244,617,627,15044000000,MAÑÓN
15,045,3737,1782,1955,15045000000,MAZARICOS
15,046,7553,3696,3857,15046000000,MELIDE
15,047,2418,1217,1201,15047000000,MESÍA
15,048,6753,3359,3394,15048000000,MIÑO
15,049,1206,586,620,15049000000,MOECHE
15,050,1838,935,903,15050000000,MONFERO
15,051,5228,2540,2688,15051000000,MUGARDOS
15,052,4450,2129,2321,15052000000,MUXÍA
15,053,8251,3983,4268,15053000000,MUROS
15,054,39051,18891,20160,15054000000,NARÓN
15,055,4910,2382,2528,15055000000,NEDA
15,056,6901,3326,3575,15056000000,NEGREIRA
15,057,14115,6764,7351,15057000000,NOIA
15,058,37809,18166,19643,15058000000,OLEIROS
15,059,12669,6186,6483,15059000000,ORDES
15,060,7622,3747,3875,15060000000,OROSO
15,061,5477,2607,2870,15061000000,ORTIGUEIRA
15,062,6082,2915,3167,15062000000,OUTES
15,064,2436,1199,1237,15064000000,PADERNE
15,065,8355,4049,4306,15065000000,PADRÓN
15,066,4553,2280,2273,15066000000,O PINO (O)
15,067,9227,4529,4698,15067000000,A POBRA DO CARAMIÑAL (A)
15,068,5399,2709,2690,15068000000,PONTECESO
15,069,7520,3615,3905,15069000000,PONTEDEUME
15,070,9867,4790,5077,15070000000,AS PONTES DE GARCÍA RODRÍGUEZ (AS)
15,071,9125,4527,4598,15071000000,PORTO DO SON
15,072,10854,5344,5510,15072000000,RIANXO
15,073,27030,13341,13689,15073000000,RIBEIRA
15,074,4397,2096,2301,15074000000,ROIS
15,075,16874,8228,8646,15075000000,SADA
15,076,2751,1359,1392,15076000000,SAN SADURNIÑO
15,077,9342,4545,4797,15077000000,SANTA COMBA
15,078,98687,45839,52848,15078000000,SANTIAGO DE COMPOSTELA
15,079,1473,764,709,15079000000,SANTISO
15,080,1777,923,854,15080000000,SOBRADO
15,081,1068,542,526,15081000000,AS SOMOZAS (AS)
15,082,19034,9318,9716,15082000000,TEO
15,083,1074,549,525,15083000000,TOQUES
15,084,3168,1512,1656,15084000000,TORDOIA
15,085,3382,1686,1696,15085000000,TOURO
15,086,3019,1476,1543,15086000000,TRAZO
15,087,6889,3362,3527,15087000000,VALDOVIÑO
15,088,3761,1834,1927,15088000000,VAL DO DUBRA
15,089,5019,2458,2561,15089000000,VEDRA
15,090,1232,652,580,15090000000,VILASANTAR
15,091,1234,629,605,15091000000,VILARMAIOR
15,092,6840,3298,3542,15092000000,VIMIANZO
15,093,4308,2082,2226,15093000000,ZAS
15,901,3769,1856,1913,15901000000,CARIÑO
15,902,5203,2627,2576,15902000000,OZA-CESURAS
16,001,61,38,23,16001000000,ABIA DE LA OBISPALÍA
16,002,226,111,115,16002000000,EL ACEBRÓN (EL)
16,003,172,79,93,16003000000,ALARCÓN
16,004,225,120,105,16004000000,ALBALADEJO DEL CUENDE
16,005,267,137,130,16005000000,ALBALATE DE LAS NOGUERAS
16,006,118,58,60,16006000000,ALBENDEA
16,007,1553,785,768,16007000000,LA ALBERCA DE ZÁNCARA (LA)
16,008,79,46,33,16008000000,ALCALÁ DE LA VEGA
16,009,53,30,23,16009000000,ALCANTUD
16,010,159,87,72,16010000000,ALCÁZAR DEL REY
16,011,19,10,9,16011000000,ALCOHUJATE
16,012,77,47,30,16012000000,ALCONCHEL DE LA ESTRELLA
16,013,29,17,12,16013000000,ALGARRA
16,014,620,320,300,16014000000,ALIAGUILLA
16,015,434,234,200,16015000000,LA ALMARCHA (LA)
16,016,244,127,117,16016000000,ALMENDROS
16,017,398,207,191,16017000000,ALMODÓVAR DEL PINAR
16,018,434,224,210,16018000000,ALMONACID DEL MARQUESADO
16,019,210,116,94,16019000000,ALTAREJOS
16,020,11,6,5,16020000000,ARANDILLA DEL ARROYO
16,022,77,45,32,16022000000,ARCOS DE LA SIERRA
16,023,771,399,372,16023000000,CHILLARÓN DE CUENCA
16,024,133,67,66,16024000000,ARGUISUELAS
16,025,16,9,7,16025000000,ARRANCACEPAS
16,026,105,58,47,16026000000,ATALAYA DEL CAÑAVATE
16,027,1012,544,468,16027000000,BARAJAS DE MELO
16,029,92,60,32,16029000000,BARCHÍN DEL HOYO
16,030,24,20,4,16030000000,BASCUÑANA DE SAN PEDRO
16,031,52,29,23,16031000000,BEAMUD
16,032,398,206,192,16032000000,BELINCHÓN
16,033,1782,886,896,16033000000,BELMONTE
16,034,135,77,58,16034000000,BELMONTEJO
16,035,235,123,112,16035000000,BETETA
16,036,145,73,72,16036000000,BONICHES
16,038,38,24,14,16038000000,BUCIEGAS
16,039,453,238,215,16039000000,BUENACHE DE ALARCÓN
16,040,114,64,50,16040000000,BUENACHE DE LA SIERRA
16,041,418,222,196,16041000000,BUENDÍA
16,042,1287,654,633,16042000000,CAMPILLO DE ALTOBUEY
16,043,105,60,45,16043000000,CAMPILLOS-PARAVIENTOS
16,044,29,14,15,16044000000,CAMPILLOS-SIERRA
16,045,169,91,78,16045000000,CANALEJAS DEL ARROYO
16,046,244,136,108,16046000000,CAÑADA DEL HOYO
16,047,217,119,98,16047000000,CAÑADA JUNCOSA
16,048,449,242,207,16048000000,CAÑAMARES
16,049,138,69,69,16049000000,EL CAÑAVATE (EL)
16,050,229,114,115,16050000000,CAÑAVERAS
16,051,116,58,58,16051000000,CAÑAVERUELAS
16,052,804,415,389,16052000000,CAÑETE
16,053,442,241,201,16053000000,CAÑIZARES
16,055,774,403,371,16055000000,CARBONERAS DE GUADAZAÓN
16,056,474,250,224,16056000000,CARDENETE
16,057,67,42,25,16057000000,CARRASCOSA
16,058,96,47,49,16058000000,CARRASCOSA DE HARO
16,060,809,408,401,16060000000,CASAS DE BENÍTEZ
16,061,1132,592,540,16061000000,CASAS DE FERNANDO ALONSO
16,062,34,21,13,16062000000,CASAS DE GARCIMOLINA
16,063,110,61,49,16063000000,CASAS DE GUIJARRO
16,064,848,452,396,16064000000,CASAS DE HARO
16,065,419,212,207,16065000000,CASAS DE LOS PINOS
16,066,3157,1640,1517,16066000000,CASASIMARRO
16,067,117,68,49,16067000000,CASTEJÓN
16,068,107,58,49,16068000000,CASTILLEJO DE INIESTA
16,070,35,17,18,16070000000,CASTILLEJO-SIERRA
16,071,23,10,13,16071000000,CASTILLO-ALBARÁÑEZ
16,072,131,79,52,16072000000,CASTILLO DE GARCIMUÑOZ
16,073,210,103,107,16073000000,CERVERA DEL LLANO
16,074,38,21,17,16074000000,LA CIERVA (LA)
16,078,53512,25296,28216,16078000000,CUENCA
16,079,29,17,12,16079000000,CUEVA DEL HIERRO
16,081,61,36,25,16081000000,CHUMILLAS
16,082,315,173,142,16082000000,ENGUÍDANOS
16,083,37,19,18,16083000000,FRESNEDA DE ALTAREJOS
16,084,40,24,16,16084000000,FRESNEDA DE LA SIERRA
16,085,146,80,66,16085000000,LA FRONTERA (LA)
16,086,1234,648,586,16086000000,FUENTE DE PEDRO NAHARRO
16,087,239,119,120,16087000000,FUENTELESPINO DE HARO
16,088,107,57,50,16088000000,FUENTELESPINO DE MOYA
16,089,463,250,213,16089000000,FUENTES
16,091,70,40,30,16091000000,FUERTESCUSA
16,092,156,92,64,16092000000,GABALDÓN
16,093,62,31,31,16093000000,GARABALLA
16,094,140,83,57,16094000000,GASCUEÑA
16,095,89,48,41,16095000000,GRAJA DE CAMPALBO
16,096,357,187,170,16096000000,GRAJA DE INIESTA
16,097,134,67,67,16097000000,HENAREJOS
16,098,756,385,371,16098000000,EL HERRUMBLAR (EL)
16,099,191,98,93,16099000000,LA HINOJOSA (LA)
16,100,731,375,356,16100000000,LOS HINOJOSOS (LOS)
16,101,145,80,65,16101000000,EL HITO (EL)
16,102,1554,782,772,16102000000,HONRUBIA
16,103,256,145,111,16103000000,HONTANAYA
16,104,55,30,25,16104000000,HONTECILLAS
16,106,3671,1869,1802,16106000000,HORCAJO DE SANTIAGO
16,107,76,42,34,16107000000,HUÉLAMO
16,108,89,48,41,16108000000,HUELVES
16,109,48,26,22,16109000000,HUÉRGUINA
16,110,140,80,60,16110000000,HUERTA DE LA OBISPALÍA
16,111,177,97,80,16111000000,HUERTA DEL MARQUESADO
16,112,1708,877,831,16112000000,HUETE
16,113,4453,2220,2233,16113000000,INIESTA
16,115,57,34,23,16115000000,LAGUNA DEL MARQUESADO
16,116,49,30,19,16116000000,LAGUNASECA
16,117,1230,620,610,16117000000,LANDETE
16,118,1622,818,804,16118000000,LEDAÑA
16,119,220,115,105,16119000000,LEGANIEL
16,121,225,117,108,16121000000,LAS MAJADAS (LAS)
16,122,319,169,150,16122000000,MARIANA
16,123,65,38,27,16123000000,MASEGOSA
16,124,2276,1176,1100,16124000000,LAS MESAS (LAS)
16,125,2280,1175,1105,16125000000,MINGLANILLA
16,126,912,464,448,16126000000,MIRA
16,128,46,26,20,16128000000,MONREAL DEL LLANO
16,129,87,43,44,16129000000,MONTALBANEJO
16,130,697,356,341,16130000000,MONTALBO
16,131,134,78,56,16131000000,MONTEAGUDO DE LAS SALINAS
16,132,29,20,9,16132000000,MOTA DE ALTAREJOS
16,133,6108,3027,3081,16133000000,MOTA DEL CUERVO
16,134,6119,3063,3056,16134000000,MOTILLA DEL PALANCAR
16,135,170,93,77,16135000000,MOYA
16,137,53,34,19,16137000000,NARBONETA
16,139,310,160,150,16139000000,OLIVARES DE JÚCAR
16,140,22,13,9,16140000000,OLMEDA DE LA CUESTA
16,141,127,64,63,16141000000,OLMEDA DEL REY
16,142,133,78,55,16142000000,OLMEDILLA DE ALARCÓN
16,143,22,17,5,16143000000,OLMEDILLA DE ELIZ
16,145,443,226,217,16145000000,OSA DE LA VEGA
16,146,78,37,41,16146000000,PAJARÓN
16,147,58,32,26,16147000000,PAJARONCILLO
16,148,557,283,274,16148000000,PALOMARES DEL CAMPO
16,149,189,89,100,16149000000,PALOMERA
16,150,94,50,44,16150000000,PARACUELLOS
16,151,75,42,33,16151000000,PAREDES
16,152,34,24,10,16152000000,LA PARRA DE LAS VEGAS (LA)
16,153,1124,562,562,16153000000,EL PEDERNOSO (EL)
16,154,6550,3357,3193,16154000000,LAS PEDROÑERAS (LAS)
16,155,654,372,282,16155000000,EL PERAL (EL)
16,156,84,53,31,16156000000,LA PERALEJA (LA)
16,157,219,117,102,16157000000,LA PESQUERA (LA)
16,158,690,357,333,16158000000,EL PICAZO (EL)
16,159,190,94,96,16159000000,PINAREJO
16,160,60,40,20,16160000000,PINEDA DE GIGÜELA
16,161,46,28,18,16161000000,PIQUERAS DEL CASTILLO
16,162,36,20,16,16162000000,PORTALRUBIO DE GUADAMEJUD
16,163,56,29,27,16163000000,PORTILLA
16,165,74,47,27,16165000000,POYATOS
16,166,271,146,125,16166000000,POZOAMARGO
16,167,323,155,168,16167000000,POZORRUBIO DE SANTIAGO
16,169,45,28,17,16169000000,EL POZUELO (EL)
16,170,903,460,443,16170000000,PRIEGO
16,171,2396,1204,1192,16171000000,EL PROVENCIO (EL)
16,172,331,172,159,16172000000,PUEBLA DE ALMENARA
16,173,208,113,95,16173000000,EL VALLE DE ALTOMIRA (EL)
16,174,199,105,94,16174000000,PUEBLA DEL SALVADOR
16,175,7554,3885,3669,16175000000,QUINTANAR DEL REY
16,176,51,32,19,16176000000,RADA DE HARO
16,177,112,67,45,16177000000,REÍLLO
16,181,59,27,32,16181000000,ROZALÉN DEL MONTE
16,185,39,25,14,16185000000,SACEDA-TRASIERRA
16,186,466,246,220,16186000000,SAELICES
16,187,73,42,31,16187000000,SALINAS DEL MANZANO
16,188,103,60,43,16188000000,SALMERONCILLOS
16,189,300,154,146,16189000000,SALVACAÑETE
16,190,6776,3412,3364,16190000000,SAN CLEMENTE
16,191,1106,581,525,16191000000,SAN LORENZO DE LA PARRILLA
16,192,45,26,19,16192000000,SAN MARTÍN DE BONICHES
16,193,58,35,23,16193000000,SAN PEDRO PALMICHES
16,194,224,112,112,16194000000,SANTA CRUZ DE MOYA
16,195,531,278,253,16195000000,SANTA MARÍA DEL CAMPO RUS
16,196,683,364,319,16196000000,SANTA MARÍA DE LOS LLANOS
16,197,65,37,28,16197000000,SANTA MARÍA DEL VAL
16,198,1636,845,791,16198000000,SISANTE
16,199,31,18,13,16199000000,SOLERA DE GABALDÓN
16,202,875,457,418,16202000000,TALAYUELAS
16,203,16257,8029,8228,16203000000,TARANCÓN
16,204,299,167,132,16204000000,TÉBAR
16,205,104,50,54,16205000000,TEJADILLOS
16,206,189,103,86,16206000000,TINAJAS
16,209,109,66,43,16209000000,TORRALBA
16,211,342,193,149,16211000000,TORREJONCILLO DEL REY
16,212,311,152,159,16212000000,TORRUBIA DEL CAMPO
16,213,44,29,15,16213000000,TORRUBIA DEL CASTILLO
16,215,268,156,112,16215000000,TRAGACETE
16,216,270,151,119,16216000000,TRESJUNCOS
16,217,97,53,44,16217000000,TRIBALDOS
16,218,247,132,115,16218000000,UCLÉS
16,219,88,51,37,16219000000,UÑA
16,224,82,48,34,16224000000,VALDEMECA
16,225,53,32,21,16225000000,VALDEMORILLO DE LA SIERRA
16,227,110,63,47,16227000000,VALDEMORO-SIERRA
16,228,211,134,77,16228000000,VALDEOLIVAS
16,231,75,41,34,16231000000,VALHERMOSO DE LA FUENTE
16,234,21,11,10,16234000000,VALSALOBRE
16,236,1085,537,548,16236000000,VALVERDE DE JÚCAR
16,237,91,48,43,16237000000,VALVERDEJO
16,238,474,238,236,16238000000,VARA DE REY
16,239,142,84,58,16239000000,VEGA DEL CODORNO
16,240,119,65,54,16240000000,VELLISCA
16,242,325,171,154,16242000000,VILLACONEJOS DE TRABAQUE
16,243,490,260,230,16243000000,VILLAESCUSA DE HARO
16,244,754,376,378,16244000000,VILLAGARCÍA DEL LLANO
16,245,532,263,269,16245000000,VILLALBA DE LA SIERRA
16,246,488,263,225,16246000000,VILLALBA DEL REY
16,247,63,39,24,16247000000,VILLALGORDO DEL MARQUESADO
16,248,1008,500,508,16248000000,VILLALPARDO
16,249,2405,1235,1170,16249000000,VILLAMAYOR DE SANTIAGO
16,250,62,40,22,16250000000,VILLANUEVA DE GUADAMEJUD
16,251,2292,1167,1125,16251000000,VILLANUEVA DE LA JARA
16,253,391,212,179,16253000000,VILLAR DE CAÑAS
16,254,226,114,112,16254000000,VILLAR DE DOMINGO GARCÍA
16,255,154,76,78,16255000000,VILLAR DE LA ENCINA
16,258,186,101,85,16258000000,VILLAR DEL HUMO
16,259,30,17,13,16259000000,VILLAR DEL INFANTADO
16,263,1425,761,664,16263000000,VILLAR DE OLALLA
16,264,396,198,198,16264000000,VILLAREJO DE FUENTES
16,265,23,13,10,16265000000,VILLAREJO DE LA PEÑUELA
16,266,387,194,193,16266000000,VILLAREJO-PERIESTEBAN
16,269,464,245,219,16269000000,VILLARES DEL SAZ
16,270,207,114,93,16270000000,VILLARRUBIO
16,271,848,420,428,16271000000,VILLARTA
16,272,219,121,98,16272000000,VILLAS DE LA VENTOSA
16,273,339,181,158,16273000000,VILLAVERDE Y PASACONSOL
16,274,135,75,60,16274000000,VÍLLORA
16,275,17,11,6,16275000000,VINDEL
16,276,19,13,6,16276000000,YÉMEDA
16,277,93,55,38,16277000000,ZAFRA DE ZÁNCARA
16,278,53,28,25,16278000000,ZAFRILLA
16,279,273,150,123,16279000000,ZARZA DE TAJO
16,280,148,82,66,16280000000,ZARZUELA
16,901,672,346,326,16901000000,CAMPOS DEL PARAÍSO
16,902,123,69,54,16902000000,VALDETÓRTOLA
16,903,1587,850,737,16903000000,LAS VALERAS (LAS)
16,904,579,301,278,16904000000,FUENTENAVA DE JÁBAGA
16,905,2094,1059,1035,16905000000,ARCAS
16,906,71,47,24,16906000000,LOS VALDECOLMENAS (LOS)
16,908,171,92,79,16908000000,POZORRUBIELOS DE LA MANCHA
16,909,698,366,332,16909000000,SOTORRIBAS
16,910,78,45,33,16910000000,VILLAR Y VELASCO
17,001,923,455,468,17001000000,AGULLANA
17,002,770,384,386,17002000000,AIGUAVIVA
17,003,171,88,83,17003000000,ALBANYÀ
17,004,819,425,394,17004000000,ALBONS
17,005,612,308,304,17005000000,EL FAR D'EMPORDÀ (EL)
17,006,1719,899,820,17006000000,ALP
17,007,2423,1198,1225,17007000000,AMER
17,008,5884,2958,2926,17008000000,ANGLÈS
17,009,6531,3349,3182,17009000000,ARBÚCIES
17,010,428,214,214,17010000000,ARGELAGUER
17,011,1061,539,522,17011000000,L'ARMENTERA (L')
17,012,1681,843,838,17012000000,AVINYONET DE PUIGVENTÓS
17,013,4216,2098,2118,17013000000,BEGUR
17,014,98,57,41,17014000000,LA VAJOL (LA)
17,015,20506,10175,10331,17015000000,BANYOLES
17,016,1059,541,518,17016000000,BÀSCARA
17,018,730,355,375,17018000000,BELLCAIRE D'EMPORDÀ
17,019,2518,1186,1332,17019000000,BESALÚ
17,020,5178,2596,2582,17020000000,BESCANÓ
17,021,212,109,103,17021000000,BEUDA
17,022,11383,5696,5687,17022000000,LA BISBAL D'EMPORDÀ (LA)
17,023,41653,20715,20938,17023000000,BLANES
17,024,506,257,249,17024000000,BOLVIR
17,025,1794,902,892,17025000000,BORDILS
17,026,797,410,387,17026000000,BORRASSÀ
17,027,3898,1909,1989,17027000000,BREDA
17,028,398,204,194,17028000000,BRUNYOLA I SANT MARTÍ SAPRESA
17,029,262,131,131,17029000000,BOADELLA I LES ESCAULES
17,030,941,492,449,17030000000,CABANES
17,031,276,152,124,17031000000,CABANELLES
17,032,2912,1419,1493,17032000000,CADAQUÉS
17,033,8418,4183,4235,17033000000,CALDES DE MALAVELLA
17,034,12043,6001,6042,17034000000,CALONGE I SANT ANTONI
17,035,719,354,365,17035000000,CAMÓS
17,036,3212,1584,1628,17036000000,CAMPDEVÀNOL
17,037,164,89,75,17037000000,CAMPELLES
17,038,535,266,269,17038000000,CAMPLLONG
17,039,2487,1209,1278,17039000000,CAMPRODON
17,040,749,382,367,17040000000,CANET D'ADRI
17,041,325,168,157,17041000000,CANTALLOPS
17,042,668,342,326,17042000000,CAPMANY
17,043,197,102,95,17043000000,QUERALBS
17,044,10836,5548,5288,17044000000,CASSÀ DE LA SELVA
17,046,941,480,461,17046000000,CASTELLFOLLIT DE LA ROCA
17,047,11731,5922,5809,17047000000,CASTELLÓ D'EMPÚRIES
17,048,12566,6094,6472,17048000000,CASTELL-PLATJA D'ARO
17,049,5486,2745,2741,17049000000,CELRÀ
17,050,1007,514,493,17050000000,CERVIÀ DE TER
17,051,298,149,149,17051000000,CISTELLA
17,052,186,88,98,17052000000,SIURANA
17,054,479,247,232,17054000000,COLERA
17,055,207,104,103,17055000000,COLOMERS
17,056,2401,1204,1197,17056000000,CORNELLÀ DEL TERRI
17,057,1295,666,629,17057000000,CORÇÀ
17,058,242,125,117,17058000000,CRESPIÀ
17,060,546,287,259,17060000000,DARNIUS
17,061,257,132,125,17061000000,DAS
17,062,10478,5267,5211,17062000000,L'ESCALA (L')
17,063,248,121,127,17063000000,ESPINELVES
17,064,409,205,204,17064000000,ESPOLLA
17,065,467,243,224,17065000000,ESPONELLÀ
17,066,47879,23669,24210,17066000000,FIGUERES
17,067,1155,559,596,17067000000,FLAÇÀ
17,068,292,152,140,17068000000,FOIXÀ
17,069,533,278,255,17069000000,FONTANALS DE CERDANYA
17,070,170,95,75,17070000000,FONTANILLES
17,071,1439,736,703,17071000000,FONTCOBERTA
17,073,2732,1350,1382,17073000000,FORNELLS DE LA SELVA
17,074,786,380,406,17074000000,FORTIÀ
17,075,463,242,221,17075000000,GARRIGÀS
17,076,190,100,90,17076000000,GARRIGOLES
17,077,972,495,477,17077000000,GARRIGUELLA
17,078,507,277,230,17078000000,GER
17,079,104320,50165,54155,17079000000,GIRONA
17,080,200,99,101,17080000000,GOMBRÈN
17,081,430,250,180,17081000000,GUALTA
17,082,598,319,279,17082000000,GUILS DE CERDANYA
17,083,4410,2208,2202,17083000000,HOSTALRIC
17,084,341,188,153,17084000000,ISÒVOL
17,085,388,201,187,17085000000,JAFRE
17,086,3387,1693,1694,17086000000,LA JONQUERA (LA)
17,087,335,178,157,17087000000,JUIÀ
17,088,849,423,426,17088000000,LLADÓ
17,089,9208,4611,4597,17089000000,LLAGOSTERA
17,090,715,365,350,17090000000,LLAMBILLES
17,091,536,269,267,17091000000,LLANARS
17,092,4839,2374,2465,17092000000,LLANÇÀ
17,093,1216,609,607,17093000000,LLERS
17,094,1506,785,721,17094000000,LLÍVIA
17,095,41559,20830,20729,17095000000,LLORET DE MAR
17,096,203,117,86,17096000000,LES LLOSSES (LES)
17,097,294,143,151,17097000000,MADREMANYA
17,098,466,255,211,17098000000,MAIÀ DE MONTCAL
17,099,114,63,51,17099000000,MERANGES
17,100,299,161,138,17100000000,MASARAC
17,101,832,439,393,17101000000,MASSANES
17,102,750,375,375,17102000000,MAÇANET DE CABRENYS
17,103,7823,4035,3788,17103000000,MAÇANET DE LA SELVA
17,105,353,174,179,17105000000,MIERES
17,106,215,112,103,17106000000,MOLLET DE PERALADA
17,107,376,181,195,17107000000,MOLLÓ
17,109,979,512,467,17109000000,MONTAGUT I OIX
17,110,1671,844,827,17110000000,MONT-RAS
17,111,1465,719,746,17111000000,NAVATA
17,112,228,125,103,17112000000,OGASSA
17,114,37975,19292,18683,17114000000,OLOT
17,115,393,211,182,17115000000,ORDIS
17,116,420,225,195,17116000000,OSOR
17,117,23848,11838,12010,17117000000,PALAFRUGELL
17,118,18293,8930,9363,17118000000,PALAMÓS
17,119,128,73,55,17119000000,PALAU DE SANTA EULÀLIA
17,120,1495,753,742,17120000000,PALAU-SAVERDERA
17,121,314,172,142,17121000000,PALAU-SATOR
17,123,469,232,237,17123000000,PALOL DE REVARDIT
17,124,2539,1307,1232,17124000000,PALS
17,125,169,95,74,17125000000,PARDINES
17,126,413,204,209,17126000000,PARLAVÀ
17,128,555,273,282,17128000000,PAU
17,129,182,89,93,17129000000,PEDRET I MARZÀ
17,130,450,227,223,17130000000,LA PERA (LA)
17,132,2018,994,1024,17132000000,PERALADA
17,133,1756,880,876,17133000000,LES PLANES D'HOSTOLES (LES)
17,134,315,174,141,17134000000,PLANOLES
17,135,557,276,281,17135000000,PONT DE MOLINS
17,136,281,148,133,17136000000,PONTÓS
17,137,4723,2343,2380,17137000000,PORQUERES
17,138,1066,527,539,17138000000,PORTBOU
17,139,1903,945,958,17139000000,LES PRESES (LES)
17,140,1045,529,516,17140000000,EL PORT DE LA SELVA (EL)
17,141,9764,4898,4866,17141000000,PUIGCERDÀ
17,142,4026,2040,1986,17142000000,QUART
17,143,203,99,104,17143000000,RABÓS
17,144,269,143,126,17144000000,REGENCÓS
17,145,1839,937,902,17145000000,RIBES DE FRESER
17,146,4426,2251,2175,17146000000,RIELLS I VIABREA
17,147,10731,5311,5420,17147000000,RIPOLL
17,148,2332,1188,1144,17148000000,RIUDARENES
17,149,526,261,265,17149000000,RIUDAURA
17,150,2092,1066,1026,17150000000,RIUDELLOTS DE LA SELVA
17,151,234,122,112,17151000000,RIUMORS
17,152,20140,10214,9926,17152000000,ROSES
17,153,316,155,161,17153000000,RUPIÀ
17,154,167,85,82,17154000000,SALES DE LLIERCA
17,155,33242,17517,15725,17155000000,SALT
17,157,171,83,88,17157000000,SANT ANDREU SALOU
17,158,679,402,277,17158000000,SANT CLIMENT SESCEBES
17,159,862,443,419,17159000000,SANT FELIU DE BUIXALLEU
17,160,22751,11125,11626,17160000000,SANT FELIU DE GUÍXOLS
17,161,1601,849,752,17161000000,SANT FELIU DE PALLEROLS
17,162,248,138,110,17162000000,SANT FERRIOL
17,163,4201,2109,2092,17163000000,SANT GREGORI
17,164,5913,2988,2925,17164000000,SANT HILARI SACALM
17,165,870,429,441,17165000000,SANT JAUME DE LLIERCA
17,166,845,409,436,17166000000,SANT JORDI DESVALLS
17,167,3298,1637,1661,17167000000,SANT JOAN DE LES ABADESSES
17,168,524,261,263,17168000000,SANT JOAN DE MOLLET
17,169,3723,1878,1845,17169000000,SANT JULIÀ DE RAMIS
17,170,222,117,105,17170000000,VALLFOGONA DE RIPOLLÈS
17,171,275,139,136,17171000000,SANT LLORENÇ DE LA MUGA
17,172,709,364,345,17172000000,SANT MARTÍ DE LLÉMENA
17,173,269,146,123,17173000000,SANT MARTÍ VELL
17,174,247,135,112,17174000000,SANT MIQUEL DE CAMPMAJOR
17,175,833,435,398,17175000000,SANT MIQUEL DE FLUVIÀ
17,176,173,87,86,17176000000,SANT MORI
17,177,742,366,376,17177000000,SANT PAU DE SEGÚRIES
17,178,2122,1126,996,17178000000,SANT PERE PESCADOR
17,180,13634,6874,6760,17180000000,SANTA COLOMA DE FARNERS
17,181,5664,2879,2785,17181000000,SANTA CRISTINA D'ARO
17,182,382,182,200,17182000000,SANTA LLOGAIA D'ÀLGUEMA
17,183,364,186,178,17183000000,SANT ANIOL DE FINESTRES
17,184,1616,815,801,17184000000,SANTA PAU
17,185,3086,1563,1523,17185000000,SANT JOAN LES FONTS
17,186,5327,2646,2681,17186000000,SARRIÀ DE TER
17,187,872,431,441,17187000000,"SAUS, CAMALLERA I LLAMPAIES"
17,188,221,109,112,17188000000,LA SELVA DE MAR (LA)
17,189,2012,986,1026,17189000000,LA CELLERA DE TER (LA)
17,190,1158,592,566,17190000000,SERINYÀ
17,191,237,124,113,17191000000,SERRA DE DARÓ
17,192,185,103,82,17192000000,SETCASES
17,193,6624,3392,3232,17193000000,SILS
17,194,97,59,38,17194000000,SUSQUEDA
17,195,475,251,224,17195000000,LA TALLADA D'EMPORDÀ (LA)
17,196,346,166,180,17196000000,TERRADES
17,197,170,91,79,17197000000,TORRENT
17,198,768,393,375,17198000000,TORROELLA DE FLUVIÀ
17,199,12356,6316,6040,17199000000,TORROELLA DE MONTGRÍ
17,200,822,385,437,17200000000,TORTELLÀ
17,201,189,108,81,17201000000,TOSES
17,202,6206,3146,3060,17202000000,TOSSA DE MAR
17,203,224,117,107,17203000000,ULTRAMORT
17,204,1193,644,549,17204000000,ULLÀ
17,205,261,135,126,17205000000,ULLASTRET
17,206,212,109,103,17206000000,URÚS
17,207,3178,1599,1579,17207000000,LA VALL D'EN BAS (LA)
17,208,1356,672,684,17208000000,LA VALL DE BIANYA (LA)
17,209,908,456,452,17209000000,VALL-LLOBREGA
17,210,903,458,445,17210000000,VENTALLÓ
17,211,1165,574,591,17211000000,VERGES
17,212,178,89,89,17212000000,VIDRÀ
17,213,8339,4300,4039,17213000000,VIDRERES
17,214,995,497,498,17214000000,VILABERTRAN
17,215,3511,1753,1758,17215000000,VILABLAREIX
17,216,222,122,100,17216000000,VILADASENS
17,217,488,247,241,17217000000,VILADAMAT
17,218,842,434,408,17218000000,VILADEMULS
17,220,1133,568,565,17220000000,VILADRAU
17,221,5642,2789,2853,17221000000,VILAFANT
17,222,167,88,79,17222000000,VILAÜR
17,223,1153,572,581,17223000000,VILAJUÏGA
17,224,399,218,181,17224000000,VILALLONGA DE TER
17,225,379,214,165,17225000000,VILAMACOLUM
17,226,1188,601,587,17226000000,VILAMALLA
17,227,198,112,86,17227000000,VILAMANISCLE
17,228,413,201,212,17228000000,VILANANT
17,230,785,376,409,17230000000,VILA-SACRA
17,232,200,104,96,17232000000,VILOPRIU
17,233,3278,1704,1574,17233000000,VILOBÍ D'ONYAR
17,234,240,130,110,17234000000,BIURE
17,901,1323,675,648,17901000000,"CRUÏLLES, MONELLS I SANT SADURNÍ DE L'HEURA"
17,902,1752,852,900,17902000000,FORALLAC
17,903,1359,703,656,17903000000,SANT JULIÀ DEL LLOR I BONMATÍ
18,001,239,126,113,18001000000,AGRÓN
18,002,562,288,274,18002000000,ALAMEDILLA
18,003,19474,9531,9943,18003000000,ALBOLOTE
18,004,735,400,335,18004000000,ALBONDÓN
18,005,419,215,204,18005000000,ALBUÑÁN
18,006,7391,4089,3302,18006000000,ALBUÑOL
18,007,785,394,391,18007000000,ALBUÑUELAS
18,010,594,306,288,18010000000,ALDEIRE
18,011,5688,2893,2795,18011000000,ALFACAR
18,012,2396,1229,1167,18012000000,ALGARINEJO
18,013,5655,2939,2716,18013000000,ALHAMA DE GRANADA
18,014,10216,5154,5062,18014000000,ALHENDÍN
18,015,450,227,223,18015000000,ALICÚN DE ORTEGA
18,016,335,165,170,18016000000,ALMEGÍJAR
18,017,27305,13593,13712,18017000000,ALMUÑÉCAR
18,018,581,297,284,18018000000,ALQUIFE
18,020,617,325,292,18020000000,ARENAS DEL REY
18,021,25059,12357,12702,18021000000,ARMILLA
18,022,20024,10034,9990,18022000000,ATARFE
18,023,20579,10198,10381,18023000000,BAZA
18,024,992,522,470,18024000000,BEAS DE GRANADA
18,025,315,160,155,18025000000,BEAS DE GUADIX
18,027,3324,1631,1693,18027000000,BENALÚA
18,028,1030,541,489,18028000000,BENALÚA DE LAS VILLAS
18,029,2250,1122,1128,18029000000,BENAMAUREL
18,030,690,379,311,18030000000,BÉRCHULES
18,032,309,163,146,18032000000,BUBIÓN
18,033,319,163,156,18033000000,BUSQUÍSTAR
18,034,527,277,250,18034000000,CACÍN
18,035,1539,816,723,18035000000,CÁDIAR
18,036,5447,2691,2756,18036000000,CÁJAR
18,037,650,322,328,18037000000,CALICASAS
18,038,1250,623,627,18038000000,CAMPOTÉJAR
18,039,3910,1993,1917,18039000000,CANILES
18,040,397,211,186,18040000000,CÁÑAR
18,042,582,287,295,18042000000,CAPILEIRA
18,043,234,125,109,18043000000,CARATAUNAS
18,044,224,132,92,18044000000,CÁSTARAS
18,045,1288,679,609,18045000000,CASTILLÉJAR
18,046,1992,1038,954,18046000000,CASTRIL
18,047,8231,4107,4124,18047000000,CENES DE LA VEGA
18,048,3630,1841,1789,18048000000,CIJUELA
18,049,658,376,282,18049000000,COGOLLOS DE GUADIX
18,050,2064,1056,1008,18050000000,COGOLLOS DE LA VEGA
18,051,1290,679,611,18051000000,COLOMERA
18,053,1810,904,906,18053000000,CORTES DE BAZA
18,054,977,511,466,18054000000,CORTES Y GRAENA
18,056,3965,1979,1986,18056000000,CÚLLAR
18,057,7770,3935,3835,18057000000,CÚLLAR VEGA
18,059,5679,2800,2879,18059000000,CHAUCHINA
18,061,1238,650,588,18061000000,CHIMENEAS
18,062,16445,8097,8348,18062000000,CHURRIANA DE LA VEGA
18,063,1658,846,812,18063000000,DARRO
18,064,395,194,201,18064000000,DEHESAS DE GUADIX
18,065,650,333,317,18065000000,DEHESAS VIEJAS
18,066,2624,1321,1303,18066000000,DEIFONTES
18,067,799,434,365,18067000000,DIEZMA
18,068,2264,1138,1126,18068000000,DÍLAR
18,069,624,333,291,18069000000,DÓLAR
18,070,378,200,178,18070000000,DÚDAR
18,071,7233,3635,3598,18071000000,DÚRCAL
18,072,841,443,398,18072000000,ESCÚZAR
18,074,317,165,152,18074000000,FERREIRA
18,076,987,523,464,18076000000,FONELAS
18,077,543,287,256,18077000000,FORNES
18,078,894,469,425,18078000000,FREILA
18,079,4594,2298,2296,18079000000,FUENTE VAQUEROS
18,082,1108,556,552,18082000000,GALERA
18,083,252,128,124,18083000000,GOBERNADOR
18,084,6203,3129,3074,18084000000,GÓJAR
18,085,757,393,364,18085000000,GOR
18,086,382,197,185,18086000000,GORAFE
18,087,230595,106426,124169,18087000000,GRANADA
18,088,1816,930,886,18088000000,GUADAHORTUNA
18,089,18527,9211,9316,18089000000,GUADIX
18,093,5308,2823,2485,18093000000,GUALCHOS
18,094,2909,1546,1363,18094000000,GÜÉJAR SIERRA
18,095,2677,1390,1287,18095000000,GÜEVÉJAR
18,096,365,189,176,18096000000,HUÉLAGO
18,097,1192,643,549,18097000000,HUÉNEJA
18,098,7220,3576,3644,18098000000,HUÉSCAR
18,099,1929,987,942,18099000000,HUÉTOR DE SANTILLÁN
18,100,10673,5381,5292,18100000000,HUÉTOR TÁJAR
18,101,12159,6076,6083,18101000000,HUÉTOR VEGA
18,102,9951,5041,4910,18102000000,ÍLLORA
18,103,960,473,487,18103000000,ÍTRABO
18,105,5161,2641,2520,18105000000,IZNALLOZ
18,106,582,318,264,18106000000,JÁTAR
18,107,993,519,474,18107000000,JAYENA
18,108,983,494,489,18108000000,JÉREZ DEL MARQUESADO
18,109,994,526,468,18109000000,JETE
18,111,4061,2066,1995,18111000000,JUN
18,112,146,78,68,18112000000,JUVILES
18,114,683,350,333,18114000000,LA CALAHORRA (LA)
18,115,3755,1902,1853,18115000000,LÁCHAR
18,116,3664,1835,1829,18116000000,LANJARÓN
18,117,555,297,258,18117000000,LANTEIRA
18,119,2258,1141,1117,18119000000,LECRÍN
18,120,339,170,169,18120000000,LENTEGÍ
18,121,149,73,76,18121000000,LOBRAS
18,122,20580,10271,10309,18122000000,LOJA
18,123,305,156,149,18123000000,LUGROS
18,124,480,263,217,18124000000,LÚJAR
18,126,1845,924,921,18126000000,LA MALAHÁ (LA)
18,127,22275,10855,11420,18127000000,MARACENA
18,128,411,194,217,18128000000,MARCHAL
18,132,3558,1781,1777,18132000000,MOCLÍN
18,133,2752,1423,1329,18133000000,MOLVÍZAR
18,134,8349,4236,4113,18134000000,MONACHIL
18,135,5376,2812,2564,18135000000,MONTEFRÍO
18,136,2039,1051,988,18136000000,MONTEJÍCAR
18,137,1069,575,494,18137000000,MONTILLANA
18,138,3130,1579,1551,18138000000,MORALEDA DE ZAFAYONA
18,140,58939,28877,30062,18140000000,MOTRIL
18,141,458,257,201,18141000000,MURTAS
18,143,1228,625,603,18143000000,NIGÜELAS
18,144,1093,561,532,18144000000,NÍVAR
18,145,14803,7312,7491,18145000000,OGÍJARES
18,146,1147,559,588,18146000000,ORCE
18,147,5709,2853,2856,18147000000,ÓRGIVA
18,148,1034,539,495,18148000000,OTÍVAR
18,149,7466,3759,3707,18149000000,VILLA DE OTURA
18,150,9436,4716,4720,18150000000,PADUL
18,151,310,157,153,18151000000,PAMPANEIRA
18,152,1160,579,581,18152000000,PEDRO MARTÍNEZ
18,153,11676,5752,5924,18153000000,PELIGROS
18,154,1128,583,545,18154000000,LA PEZA (LA)
18,157,1595,816,779,18157000000,PINOS GENIL
18,158,9664,4827,4837,18158000000,PINOS PUENTE
18,159,1099,597,502,18159000000,PÍÑAR
18,161,274,147,127,18161000000,POLÍCAR
18,162,1644,901,743,18162000000,POLOPOS
18,163,388,199,189,18163000000,PÓRTUGOS
18,164,2207,1125,1082,18164000000,PUEBLA DE DON FADRIQUE
18,165,5559,2774,2785,18165000000,PULIANAS
18,167,2313,1166,1147,18167000000,PURULLENA
18,168,956,498,458,18168000000,QUÉNTAR
18,170,406,234,172,18170000000,RUBITE
18,171,2617,1312,1305,18171000000,SALAR
18,173,12562,6248,6314,18173000000,SALOBREÑA
18,174,530,274,256,18174000000,SANTA CRUZ DEL COMERCIO
18,175,15105,7430,7675,18175000000,SANTA FE
18,176,283,154,129,18176000000,SOPORTÚJAR
18,177,524,287,237,18177000000,SORVILÁN
18,178,736,389,347,18178000000,TORRE-CARDELA
18,179,618,326,292,18179000000,TORVIZCÓN
18,180,702,370,332,18180000000,TREVÉLEZ
18,181,219,131,88,18181000000,TURÓN
18,182,2574,1284,1290,18182000000,UGÍJAR
18,183,676,356,320,18183000000,VÁLOR
18,184,3013,1542,1471,18184000000,VÉLEZ DE BENAUDALLA
18,185,651,362,289,18185000000,VENTAS DE HUELMA
18,187,527,292,235,18187000000,VILLANUEVA DE LAS TORRES
18,188,2009,975,1034,18188000000,VILLANUEVA MESÍA
18,189,1003,524,479,18189000000,VÍZNAR
18,192,2157,1163,994,18192000000,ZAFARRAYA
18,193,19885,9831,10054,18193000000,LA ZUBIA (LA)
18,194,2568,1307,1261,18194000000,ZÚJAR
18,901,769,377,392,18901000000,LA TAHA (LA)
18,902,936,475,461,18902000000,EL VALLE (EL)
18,903,1105,572,533,18903000000,NEVADA
18,904,940,522,418,18904000000,ALPUJARRA DE LA SIERRA
18,905,22829,11520,11309,18905000000,LAS GABIAS (LAS)
18,906,1157,625,532,18906000000,LOS GUÁJARES (LOS)
18,907,2116,1072,1044,18907000000,VALLE DEL ZALABÍ
18,908,986,510,476,18908000000,VILLAMENA
18,909,585,313,272,18909000000,MORELÁBOR
18,910,867,459,408,18910000000,EL PINAR (EL)
18,911,12165,6165,6000,18911000000,VEGAS DEL GENIL
18,912,1793,891,902,18912000000,CUEVAS DEL CAMPO
18,913,865,447,418,18913000000,ZAGRA
18,914,2060,1021,1039,18914000000,VALDERRUBIO
18,915,836,443,393,18915000000,DOMINGO PÉREZ DE GRANADA
18,916,3115,1646,1469,18916000000,TORRENUEVA COSTA
19,001,62,38,24,19001000000,ABÁNADES
19,002,66,42,24,19002000000,ABLANQUE
19,003,30,18,12,19003000000,ADOBES
19,004,62,32,30,19004000000,ALAMINOS
19,005,138,84,54,19005000000,ALARILLA
19,006,1132,629,503,19006000000,ALBALATE DE ZORITA
19,007,523,266,257,19007000000,ALBARES
19,008,45,30,15,19008000000,ALBENDIEGO
19,009,336,168,168,19009000000,ALCOCER
19,010,12,8,4,19010000000,ALCOLEA DE LAS PEÑAS
19,011,329,192,137,19011000000,ALCOLEA DEL PINAR
19,013,131,81,50,19013000000,ALCOROCHES
19,015,104,63,41,19015000000,ALDEANUEVA DE GUADALAJARA
19,016,46,33,13,19016000000,ALGAR DE MESA
19,017,98,58,40,19017000000,ALGORA
19,018,169,100,69,19018000000,ALHÓNDIGA
19,019,14,6,8,19019000000,ALIQUE
19,020,55,38,17,19020000000,ALMADRONES
19,021,1415,715,700,19021000000,ALMOGUERA
19,022,638,325,313,19022000000,ALMONACID DE ZORITA
19,023,154,80,74,19023000000,ALOCÉN
19,024,13407,6809,6598,19024000000,ALOVERA
19,027,131,74,57,19027000000,ALUSTANTE
19,031,7,6,1,19031000000,ANGÓN
19,032,157,82,75,19032000000,ANGUITA
19,033,56,31,25,19033000000,ANQUELA DEL DUCADO
19,034,27,17,10,19034000000,ANQUELA DEL PEDREGAL
19,036,381,200,181,19036000000,ARANZUEQUE
19,037,145,84,61,19037000000,ARBANCÓN
19,038,19,15,4,19038000000,ARBETETA
19,039,70,50,20,19039000000,ARGECILLA
19,040,55,31,24,19040000000,ARMALLONES
19,041,269,133,136,19041000000,ARMUÑA DE TAJUÑA
19,042,33,18,15,19042000000,ARROYO DE LAS FRAGUAS
19,043,94,64,30,19043000000,ATANZÓN
19,044,434,251,183,19044000000,ATIENZA
19,045,146,78,68,19045000000,AUÑÓN
19,046,35498,17878,17620,19046000000,AZUQUECA DE HENARES
19,047,56,27,29,19047000000,BAIDES
19,048,15,10,5,19048000000,BAÑOS DE TAJO
19,049,13,11,2,19049000000,BAÑUELOS
19,050,20,12,8,19050000000,BARRIOPEDRO
19,051,50,35,15,19051000000,BERNINCHES
19,052,21,14,7,19052000000,LA BODERA (LA)
19,053,2734,1416,1318,19053000000,BRIHUEGA
19,054,208,122,86,19054000000,BUDIA
19,055,47,23,24,19055000000,BUJALARO
19,057,68,41,27,19057000000,BUSTARES
19,058,11034,5550,5484,19058000000,CABANILLAS DEL CAMPO
19,059,76,46,30,19059000000,CAMPILLO DE DUEÑAS
19,060,155,95,60,19060000000,CAMPILLO DE RANAS
19,061,84,58,26,19061000000,CAMPISÁBALOS
19,064,87,55,32,19064000000,CANREDONDO
19,065,126,69,57,19065000000,CANTALOJAS
19,066,71,42,29,19066000000,CAÑIZAR
19,067,55,34,21,19067000000,EL CARDOSO DE LA SIERRA (EL)
19,070,100,60,40,19070000000,CASA DE UCEDA
19,071,13327,6736,6591,19071000000,EL CASAR (EL)
19,073,19,14,5,19073000000,CASAS DE SAN GALINDO
19,074,138,83,55,19074000000,CASPUEÑAS
19,075,61,38,23,19075000000,CASTEJÓN DE HENARES
19,076,23,13,10,19076000000,CASTELLAR DE LA MUELA
19,078,58,35,23,19078000000,CASTILFORTE
19,079,8,6,2,19079000000,CASTILNUEVO
19,080,69,38,31,19080000000,CENDEJAS DE ENMEDIO
19,081,23,17,6,19081000000,CENDEJAS DE LA TORRE
19,082,147,85,62,19082000000,CENTENERA
19,086,1682,865,817,19086000000,CIFUENTES
19,087,23,13,10,19087000000,CINCOVILLAS
19,088,141,77,64,19088000000,CIRUELAS
19,089,29,17,12,19089000000,CIRUELOS DEL PINAR
19,090,101,49,52,19090000000,COBETA
19,091,21,14,7,19091000000,COGOLLOR
19,092,561,324,237,19092000000,COGOLLUDO
19,095,12,10,2,19095000000,CONDEMIOS DE ABAJO
19,096,116,67,49,19096000000,CONDEMIOS DE ARRIBA
19,097,13,10,3,19097000000,CONGOSTRINA
19,098,38,24,14,19098000000,COPERNAL
19,099,310,175,135,19099000000,CORDUENTE
19,102,118,70,48,19102000000,EL CUBILLO DE UCEDA (EL)
19,103,285,164,121,19103000000,CHECA
19,104,14,8,6,19104000000,CHEQUILLA
19,105,3977,2063,1914,19105000000,CHILOECHES
19,106,85,50,35,19106000000,CHILLARÓN DEL REY
19,107,349,199,150,19107000000,DRIEBES
19,108,115,62,53,19108000000,DURÓN
19,109,30,18,12,19109000000,EMBID
19,110,64,41,23,19110000000,ESCAMILLA
19,111,188,117,71,19111000000,ESCARICHE
19,112,68,36,32,19112000000,ESCOPETE
19,113,663,340,323,19113000000,ESPINOSA DE HENARES
19,114,37,21,16,19114000000,ESPLEGARES
19,115,29,18,11,19115000000,ESTABLÉS
19,116,12,9,3,19116000000,ESTRIÉGANA
19,117,2637,1379,1258,19117000000,FONTANAR
19,118,11,7,4,19118000000,FUEMBELLIDA
19,119,84,53,31,19119000000,FUENCEMILLÁN
19,120,109,65,44,19120000000,FUENTELAHIGUERA DE ALBATAGES
19,121,324,175,149,19121000000,FUENTELENCINA
19,122,90,46,44,19122000000,FUENTELSAZ
19,123,53,32,21,19123000000,FUENTELVIEJO
19,124,587,325,262,19124000000,FUENTENOVILLA
19,125,61,37,24,19125000000,GAJANEJOS
19,126,2673,1386,1287,19126000000,GALÁPAGOS
19,127,96,53,43,19127000000,GALVE DE SORBE
19,129,31,21,10,19129000000,GASCUEÑA DE BORNOVA
19,130,89010,42787,46223,19130000000,GUADALAJARA
19,132,85,44,41,19132000000,HENCHE
19,133,224,129,95,19133000000,HERAS DE AYUSO
19,134,20,12,8,19134000000,HERRERÍA
19,135,115,69,46,19135000000,HIENDELAENCINA
19,136,20,11,9,19136000000,HIJES
19,138,319,177,142,19138000000,HITA
19,139,51,28,23,19139000000,HOMBRADOS
19,142,431,242,189,19142000000,HONTOBA
19,143,2778,1396,1382,19143000000,HORCHE
19,145,37,21,16,19145000000,HORTEZUELA DE OCÉN
19,146,56,34,22,19146000000,LA HUERCE (LA)
19,147,41,29,12,19147000000,HUÉRMECES DEL CERRO
19,148,56,37,19,19148000000,HUERTAHERNANDO
19,150,112,68,44,19150000000,HUEVA
19,151,1724,880,844,19151000000,HUMANES
19,152,878,481,397,19152000000,ILLANA
19,153,18,13,5,19153000000,INIÉSTOLA
19,154,58,40,18,19154000000,LAS INVIERNAS (LAS)
19,155,68,45,23,19155000000,IRUESTE
19,156,1417,742,675,19156000000,JADRAQUE
19,157,49,32,17,19157000000,JIRUEQUE
19,159,105,52,53,19159000000,LEDANCA
19,160,1509,834,675,19160000000,LORANCA DE TAJUÑA
19,161,293,158,135,19161000000,LUPIANA
19,162,68,37,31,19162000000,LUZAGA
19,163,64,31,33,19163000000,LUZÓN
19,165,53,36,17,19165000000,MAJAELRAYO
19,166,172,102,70,19166000000,MÁLAGA DEL FRESNO
19,167,193,108,85,19167000000,MALAGUILLA
19,168,300,149,151,19168000000,MANDAYONA
19,169,29,18,11,19169000000,MANTIEL
19,170,213,112,101,19170000000,MARANCHÓN
19,171,8273,4145,4128,19171000000,MARCHAMALO
19,172,74,41,33,19172000000,MASEGOSO DE TAJUÑA
19,173,70,46,24,19173000000,MATARRUBIA
19,174,104,56,48,19174000000,MATILLAS
19,175,27,15,12,19175000000,MAZARETE
19,176,312,175,137,19176000000,MAZUECOS
19,177,68,33,35,19177000000,MEDRANDA
19,178,31,20,11,19178000000,MEGINA
19,179,95,58,37,19179000000,MEMBRILLERA
19,181,58,38,20,19181000000,MIEDES DE ATIENZA
19,182,40,24,16,19182000000,LA MIERLA (LA)
19,183,70,40,30,19183000000,MILMARCOS
19,184,113,67,46,19184000000,MILLANA
19,185,30,17,13,19185000000,LA MIÑOSA (LA)
19,186,90,52,38,19186000000,MIRABUENO
19,187,56,34,22,19187000000,MIRALRÍO
19,188,40,19,21,19188000000,MOCHALES
19,189,172,97,75,19189000000,MOHERNANDO
19,190,3288,1626,1662,19190000000,MOLINA DE ARAGÓN
19,191,15,7,8,19191000000,MONASTERIO
19,192,2839,1478,1361,19192000000,MONDÉJAR
19,193,30,19,11,19193000000,MONTARRÓN
19,194,107,59,48,19194000000,MORATILLA DE LOS MELEROS
19,195,53,28,25,19195000000,MORENILLA
19,196,109,60,49,19196000000,MUDUEX
19,197,35,22,13,19197000000,LAS NAVAS DE JADRAQUE (LAS)
19,198,13,6,7,19198000000,NEGREDO
19,199,16,11,5,19199000000,OCENTEJO
19,200,87,44,43,19200000000,EL OLIVAR (EL)
19,201,61,31,30,19201000000,OLMEDA DE COBETA
19,202,19,12,7,19202000000,LA OLMEDA DE JADRAQUE (LA)
19,203,35,23,12,19203000000,EL ORDIAL (EL)
19,204,196,114,82,19204000000,OREA
19,208,46,31,15,19208000000,PÁLMACES DE JADRAQUE
19,209,37,22,15,19209000000,PARDOS
19,210,26,13,13,19210000000,PAREDES DE SIGÜENZA
19,211,464,277,187,19211000000,PAREJA
19,212,901,445,456,19212000000,PASTRANA
19,213,63,43,20,19213000000,EL PEDREGAL (EL)
19,214,79,44,35,19214000000,PEÑALÉN
19,215,181,111,70,19215000000,PEÑALVER
19,216,158,78,80,19216000000,PERALEJOS DE LAS TRUCHAS
19,217,83,59,24,19217000000,PERALVECHE
19,218,51,34,17,19218000000,PINILLA DE JADRAQUE
19,219,11,10,1,19219000000,PINILLA DE MOLINA
19,220,5131,2661,2470,19220000000,PIOZ
19,221,36,26,10,19221000000,PIQUERAS
19,222,100,53,47,19222000000,EL POBO DE DUEÑAS (EL)
19,223,113,63,50,19223000000,POVEDA DE LA SIERRA
19,224,113,67,46,19224000000,POZO DE ALMOGUERA
19,225,1626,875,751,19225000000,POZO DE GUADALAJARA
19,226,56,39,17,19226000000,PRÁDENA DE ATIENZA
19,227,50,39,11,19227000000,PRADOS REDONDOS
19,228,52,36,16,19228000000,PUEBLA DE BELEÑA
19,229,67,37,30,19229000000,PUEBLA DE VALLES
19,230,1031,547,484,19230000000,QUER
19,231,10,6,4,19231000000,REBOLLOSA DE JADRAQUE
19,232,71,43,28,19232000000,EL RECUENCO (EL)
19,233,102,68,34,19233000000,RENERA
19,234,54,35,19,19234000000,RETIENDAS
19,235,103,60,43,19235000000,RIBA DE SAELICES
19,237,44,26,18,19237000000,RILLO DE GALLO
19,238,64,38,26,19238000000,RIOFRÍO DEL LLANO
19,239,178,106,72,19239000000,ROBLEDILLO DE MOHERNANDO
19,240,45,24,21,19240000000,ROBLEDO DE CORPES
19,241,31,22,9,19241000000,ROMANILLOS DE ATIENZA
19,242,116,64,52,19242000000,ROMANONES
19,243,38,27,11,19243000000,RUEDA DE LA SIERRA
19,244,102,66,36,19244000000,SACECORBO
19,245,1566,803,763,19245000000,SACEDÓN
19,246,47,28,19,19246000000,SAELICES DE LA SAL
19,247,144,80,64,19247000000,SALMERÓN
19,248,75,48,27,19248000000,SAN ANDRÉS DEL CONGOSTO
19,249,39,21,18,19249000000,SAN ANDRÉS DEL REY
19,250,15,11,4,19250000000,SANTIUSTE
19,251,47,25,22,19251000000,SAÚCA
19,252,63,35,28,19252000000,SAYATÓN
19,254,36,18,18,19254000000,SELAS
19,255,81,47,34,19255000000,SETILES
19,256,45,26,19,19256000000,SIENES
19,257,4708,2428,2280,19257000000,SIGÜENZA
19,258,86,58,28,19258000000,SOLANILLOS DEL EXTREMO
19,259,27,14,13,19259000000,SOMOLINOS
19,260,34,17,17,19260000000,EL SOTILLO (EL)
19,261,30,17,13,19261000000,SOTODOSOS
19,262,148,83,65,19262000000,TAMAJÓN
19,263,52,33,19,19263000000,TARAGUDO
19,264,42,27,15,19264000000,TARAVILLA
19,265,162,90,72,19265000000,TARTANEDO
19,266,312,167,145,19266000000,TENDILLA
19,267,19,11,8,19267000000,TERZAGA
19,268,37,19,18,19268000000,TIERZO
19,269,74,51,23,19269000000,LA TOBA (LA)
19,270,16,12,4,19270000000,TORDELRÁBANO
19,271,43,23,20,19271000000,TORDELLEGO
19,272,92,51,41,19272000000,TORDESILOS
19,274,1725,889,836,19274000000,TORIJA
19,277,19,13,6,19277000000,TORRECUADRADA DE MOLINA
19,278,29,17,12,19278000000,TORRECUADRADILLA
19,279,467,268,199,19279000000,TORRE DEL BURGO
19,280,6210,3236,2974,19280000000,TORREJÓN DEL REY
19,281,20,12,8,19281000000,TORREMOCHA DE JADRAQUE
19,282,191,111,80,19282000000,TORREMOCHA DEL CAMPO
19,283,35,18,17,19283000000,TORREMOCHA DEL PINAR
19,284,6,5,1,19284000000,TORREMOCHUELA
19,285,23,15,8,19285000000,TORRUBIA
19,286,1382,733,649,19286000000,TÓRTOLA DE HENARES
19,287,169,86,83,19287000000,TORTUERA
19,288,20,15,5,19288000000,TORTUERO
19,289,22,14,8,19289000000,TRAÍD
19,290,1560,824,736,19290000000,TRIJUEQUE
19,291,1388,736,652,19291000000,TRILLO
19,293,3143,1619,1524,19293000000,UCEDA
19,294,25,12,13,19294000000,UJADOS
19,296,33,25,8,19296000000,UTANDE
19,297,46,23,23,19297000000,VALDARACHAS
19,298,87,50,37,19298000000,VALDEARENAS
19,299,108,59,49,19299000000,VALDEAVELLANO
19,300,1206,621,585,19300000000,VALDEAVERUELO
19,301,47,30,17,19301000000,VALDECONCHA
19,302,51,34,17,19302000000,VALDEGRUDAS
19,303,38,25,13,19303000000,VALDELCUBO
19,304,335,183,152,19304000000,VALDENUÑO FERNÁNDEZ
19,305,146,88,58,19305000000,VALDEPEÑAS DE LA SIERRA
19,306,29,16,13,19306000000,VALDERREBOLLO
19,307,29,19,10,19307000000,VALDESOTOS
19,308,85,52,33,19308000000,VALFERMOSO DE TAJUÑA
19,309,21,14,7,19309000000,VALHERMOSO
19,310,8,5,3,19310000000,VALTABLADO DEL RÍO
19,311,91,52,39,19311000000,VALVERDE DE LOS ARROYOS
19,314,39,25,14,19314000000,VIANA DE JADRAQUE
19,317,140,82,58,19317000000,VILLANUEVA DE ALCORÓN
19,318,34,19,15,19318000000,VILLANUEVA DE ARGECILLA
19,319,6603,3344,3259,19319000000,VILLANUEVA DE LA TORRE
19,321,46,31,15,19321000000,VILLARES DE JADRAQUE
19,322,24,15,9,19322000000,VILLASECA DE HENARES
19,323,49,28,21,19323000000,VILLASECA DE UCEDA
19,324,164,97,67,19324000000,VILLEL DE MESA
19,325,186,96,90,19325000000,VIÑUELAS
19,326,5220,2674,2546,19326000000,YEBES
19,327,490,266,224,19327000000,YEBRA
19,329,59,27,32,19329000000,YÉLAMOS DE ABAJO
19,330,84,50,34,19330000000,YÉLAMOS DE ARRIBA
19,331,4429,2264,2165,19331000000,YUNQUERA DE HENARES
19,332,94,53,41,19332000000,LA YUNTA (LA)
19,333,112,75,37,19333000000,ZAOREJAS
19,334,60,39,21,19334000000,ZARZUELA DE JADRAQUE
19,335,58,34,24,19335000000,ZORITA DE LOS CANES
19,901,30,19,11,19901000000,SEMILLAS
20,001,326,185,141,20001000000,ABALTZISKETA
20,002,506,270,236,20002000000,ADUNA
20,003,771,394,377,20003000000,AIZARNAZABAL
20,004,325,169,156,20004000000,ALBIZTUR
20,005,1771,923,848,20005000000,ALEGIA
20,006,371,181,190,20006000000,ALKIZA
20,007,448,237,211,20007000000,ALTZO
20,008,937,498,439,20008000000,AMEZKETA
20,009,14555,7221,7334,20009000000,ANDOAIN
20,010,2095,1075,1020,20010000000,ANOETA
20,011,2082,1035,1047,20011000000,ANTZUOLA
20,012,189,91,98,20012000000,ARAMA
20,013,7155,3572,3583,20013000000,ARETXABALETA
20,014,1546,785,761,20014000000,ASTEASU
20,015,1694,881,813,20015000000,ATAUN
20,016,2136,1124,1012,20016000000,AIA
20,017,11636,5774,5862,20017000000,AZKOITIA
20,018,15183,7606,7577,20018000000,AZPEITIA
20,019,13970,6983,6987,20019000000,BEASAIN
20,020,134,84,50,20020000000,BEIZAMA
20,021,286,151,135,20021000000,BELAUNTZA
20,022,1083,556,527,20022000000,BERASTEGI
20,023,575,306,269,20023000000,BERROBI
20,024,538,278,260,20024000000,BIDANIA-GOIATZ
20,025,1542,785,757,20025000000,ZEGAMA
20,026,280,133,147,20026000000,ZERAIN
20,027,3785,1973,1812,20027000000,ZESTOA
20,028,2975,1497,1478,20028000000,ZIZURKIL
20,029,5393,2670,2723,20029000000,DEBA
20,030,27234,13219,14015,20030000000,EIBAR
20,031,237,116,121,20031000000,ELDUAIN
20,032,11500,5660,5840,20032000000,ELGOIBAR
20,033,1119,563,556,20033000000,ELGETA
20,034,4194,2102,2092,20034000000,ESKORIATZA
20,035,604,307,297,20035000000,EZKIO-ITSASO
20,036,16887,8384,8503,20036000000,HONDARRIBIA
20,037,124,71,53,20037000000,GAINTZA
20,038,506,268,238,20038000000,GABIRIA
20,039,2868,1436,1432,20039000000,GETARIA
20,040,20527,10053,10474,20040000000,HERNANI
20,041,313,165,148,20041000000,HERNIALDE
20,042,4130,2029,2101,20042000000,IBARRA
20,043,2275,1146,1129,20043000000,IDIAZABAL
20,044,487,249,238,20044000000,IKAZTEGIETA
20,045,62920,30803,32117,20045000000,IRUN
20,046,1887,981,906,20046000000,IRURA
20,047,656,337,319,20047000000,ITSASONDO
20,048,257,144,113,20048000000,LARRAUL
20,049,6013,3008,3005,20049000000,LAZKAO
20,050,394,211,183,20050000000,LEABURU
20,051,8341,4189,4152,20051000000,LEGAZPI
20,052,1464,735,729,20052000000,LEGORRETA
20,053,6008,2978,3030,20053000000,LEZO
20,054,637,334,303,20054000000,LIZARTZA
20,055,21867,10732,11135,20055000000,ARRASATE/MONDRAGÓN
20,056,5313,2673,2640,20056000000,MUTRIKU
20,057,262,131,131,20057000000,MUTILOA
20,058,918,466,452,20058000000,OLABERRIA
20,059,11567,5709,5858,20059000000,OÑATI
20,060,108,61,47,20060000000,OREXA
20,061,6125,3063,3062,20061000000,ORIO
20,062,1228,627,601,20062000000,ORMAIZTEGI
20,063,10331,5127,5204,20063000000,OIARTZUN
20,064,15857,7610,8247,20064000000,PASAIA
20,065,3751,1898,1853,20065000000,SORALUZE-PLACENCIA DE LAS ARMAS
20,066,582,305,277,20066000000,ERREZIL
20,067,39231,18944,20287,20067000000,ERRENTERIA
20,068,194,110,84,20068000000,LEINTZ-GATZAGA
20,069,188743,89152,99591,20069000000,DONOSTIA/SAN SEBASTIÁN
20,070,1460,735,725,20070000000,SEGURA
20,071,20065,9711,10354,20071000000,TOLOSA
20,072,6200,3108,3092,20072000000,URNIETA
20,073,6345,3167,3178,20073000000,USURBIL
20,074,14487,7148,7339,20074000000,BERGARA
20,075,5826,2881,2945,20075000000,VILLABONA
20,076,10641,5301,5340,20076000000,ORDIZIA
20,077,6739,3339,3400,20077000000,URRETXU
20,078,1735,879,856,20078000000,ZALDIBIA
20,079,23152,11229,11923,20079000000,ZARAUTZ
20,080,9681,4757,4924,20080000000,ZUMARRAGA
20,081,10211,5057,5154,20081000000,ZUMAIA
20,901,2010,1014,996,20901000000,MENDARO
20,902,19133,9236,9897,20902000000,LASARTE-ORIA
20,903,7666,3900,3766,20903000000,ASTIGARRAGA
20,904,149,83,66,20904000000,BALIARRAIN
20,905,240,114,126,20905000000,ORENDAIN
20,906,173,85,88,20906000000,ALTZAGA
20,907,168,86,82,20907000000,GAZTELU
21,001,780,400,380,21001000000,ALÁJAR
21,002,22259,11095,11164,21002000000,ALJARAQUE
21,003,848,435,413,21003000000,EL ALMENDRO (EL)
21,004,1793,940,853,21004000000,ALMONASTER LA REAL
21,005,25233,12515,12718,21005000000,ALMONTE
21,006,3971,1963,2008,21006000000,ALOSNO
21,007,8340,4118,4222,21007000000,ARACENA
21,008,3030,1510,1520,21008000000,AROCHE
21,009,943,474,469,21009000000,ARROYOMOLINOS DE LEÓN
21,010,21645,10848,10797,21010000000,AYAMONTE
21,011,4359,2179,2180,21011000000,BEAS
21,012,296,154,142,21012000000,BERROCAL
21,013,14263,7065,7198,21013000000,BOLLULLOS PAR DEL CONDADO
21,014,6101,3021,3080,21014000000,BONARES
21,015,704,369,335,21015000000,CABEZAS RUBIAS
21,016,1140,574,566,21016000000,CALA
21,017,2754,1396,1358,21017000000,CALAÑAS
21,018,2015,984,1031,21018000000,EL CAMPILLO (EL)
21,019,745,378,367,21019000000,CAMPOFRÍO
21,020,382,198,184,21020000000,CAÑAVERAL DE LEÓN
21,021,21128,10762,10366,21021000000,CARTAYA
21,022,222,125,97,21022000000,CASTAÑO DEL ROBLEDO
21,023,2272,1138,1134,21023000000,EL CERRO DE ANDÉVALO (EL)
21,024,563,295,268,21024000000,CORTECONCEPCIÓN
21,025,4649,2346,2303,21025000000,CORTEGANA
21,026,299,144,155,21026000000,CORTELAZOR
21,027,63,35,28,21027000000,CUMBRES DE ENMEDIO
21,028,366,190,176,21028000000,CUMBRES DE SAN BARTOLOMÉ
21,029,1731,857,874,21029000000,CUMBRES MAYORES
21,030,2235,1121,1114,21030000000,CHUCENA
21,031,1269,640,629,21031000000,ENCINASOLA
21,032,2325,1121,1204,21032000000,ESCACENA DEL CAMPO
21,033,806,419,387,21033000000,FUENTEHERIDOS
21,034,1381,692,689,21034000000,GALAROZA
21,035,12940,6489,6451,21035000000,GIBRALEÓN
21,036,247,121,126,21036000000,LA GRANADA DE RÍO-TINTO (LA)
21,037,498,258,240,21037000000,EL GRANADO (EL)
21,038,1306,677,629,21038000000,HIGUERA DE LA SIERRA
21,039,329,165,164,21039000000,HINOJALES
21,040,4094,2066,2028,21040000000,HINOJOS
21,041,142532,68375,74157,21041000000,HUELVA
21,042,21603,10867,10736,21042000000,ISLA CRISTINA
21,043,2208,1109,1099,21043000000,JABUGO
21,044,28813,14879,13934,21044000000,LEPE
21,045,283,136,147,21045000000,LINARES DE LA SIERRA
21,046,3278,1736,1542,21046000000,LUCENA DEL PUERTO
21,047,2147,1097,1050,21047000000,MANZANILLA
21,048,416,217,199,21048000000,LOS MARINES (LOS)
21,049,3703,1775,1928,21049000000,MINAS DE RIOTINTO
21,050,22956,11579,11377,21050000000,MOGUER
21,051,259,136,123,21051000000,LA NAVA (LA)
21,052,5081,2455,2626,21052000000,NERVA
21,053,4244,2129,2115,21053000000,NIEBLA
21,054,10726,5344,5382,21054000000,LA PALMA DEL CONDADO (LA)
21,055,12537,6446,6091,21055000000,PALOS DE LA FRONTERA
21,056,3465,1768,1697,21056000000,PATERNA DEL CAMPO
21,057,1137,570,567,21057000000,PAYMOGO
21,058,3115,1600,1515,21058000000,PUEBLA DE GUZMÁN
21,059,282,138,144,21059000000,PUERTO MORAL
21,060,16069,8161,7908,21060000000,PUNTA UMBRÍA
21,061,8048,3968,4080,21061000000,ROCIANA DEL CONDADO
21,062,1665,811,854,21062000000,ROSAL DE LA FRONTERA
21,063,3997,2035,1962,21063000000,SAN BARTOLOMÉ DE LA TORRE
21,064,9659,4856,4803,21064000000,SAN JUAN DEL PUERTO
21,065,422,209,213,21065000000,SANLÚCAR DE GUADIANA
21,066,662,343,319,21066000000,SAN SILVESTRE DE GUZMÁN
21,067,475,223,252,21067000000,SANTA ANA LA REAL
21,068,1102,548,554,21068000000,SANTA BÁRBARA DE CASA
21,069,2038,1038,1000,21069000000,SANTA OLALLA DEL CALA
21,070,7989,3950,4039,21070000000,TRIGUEROS
21,071,243,118,125,21071000000,VALDELARCO
21,072,12655,6230,6425,21072000000,VALVERDE DEL CAMINO
21,073,2921,1472,1449,21073000000,VILLABLANCA
21,074,3335,1633,1702,21074000000,VILLALBA DEL ALCOR
21,075,393,192,201,21075000000,VILLANUEVA DE LAS CRUCES
21,076,2953,1500,1453,21076000000,VILLANUEVA DE LOS CASTILLEJOS
21,077,2148,1077,1071,21077000000,VILLARRASA
21,078,2973,1488,1485,21078000000,ZALAMEA LA REAL
21,079,753,394,359,21079000000,ZUFRE
21,902,1215,613,602,21902000000,LA ZARZA-PERRUNAL (LA)
22,001,261,134,127,22001000000,ABIEGO
22,002,162,87,75,22002000000,ABIZANDA
22,003,210,118,92,22003000000,ADAHUESCA
22,004,143,82,61,22004000000,AGÜERO
22,006,324,175,149,22006000000,AISA
22,007,1138,630,508,22007000000,ALBALATE DE CINCA
22,008,200,111,89,22008000000,ALBALATILLO
22,009,702,357,345,22009000000,ALBELDA
22,011,125,72,53,22011000000,ALBERO ALTO
22,012,130,72,58,22012000000,ALBERO BAJO
22,013,308,159,149,22013000000,ALBERUELA DE TUBO
22,014,231,120,111,22014000000,ALCALÁ DE GURREA
22,015,370,210,160,22015000000,ALCALÁ DEL OBISPO
22,016,624,293,331,22016000000,ALCAMPELL
22,017,1092,573,519,22017000000,ALCOLEA DE CINCA
22,018,412,224,188,22018000000,ALCUBIERRE
22,019,221,121,100,22019000000,ALERRE
22,020,130,66,64,22020000000,ALFÁNTEGA
22,021,2439,1230,1209,22021000000,ALMUDÉVAR
22,022,722,374,348,22022000000,ALMUNIA DE SAN JUAN
22,023,440,230,210,22023000000,ALMUNIENTE
22,024,348,179,169,22024000000,ALQUÉZAR
22,025,1429,778,651,22025000000,ALTORRICÓN
22,027,373,198,175,22027000000,ANGÜÉS
22,028,418,206,212,22028000000,ANSÓ
22,029,133,70,63,22029000000,ANTILLÓN
22,032,120,68,52,22032000000,ARAGÜÉS DEL PUERTO
22,035,308,165,143,22035000000,ARÉN
22,036,119,71,48,22036000000,ARGAVIESO
22,037,160,85,75,22037000000,ARGUIS
22,039,1073,530,543,22039000000,AYERBE
22,040,175,86,89,22040000000,AZANUY-ALINS
22,041,170,91,79,22041000000,AZARA
22,042,154,70,84,22042000000,AZLOR
22,043,91,53,38,22043000000,BAÉLLS
22,044,262,162,100,22044000000,BAILO
22,045,90,53,37,22045000000,BALDELLOU
22,046,879,454,425,22046000000,BALLOBAR
22,047,334,168,166,22047000000,BANASTÁS
22,048,17295,8436,8859,22048000000,BARBASTRO
22,049,86,52,34,22049000000,BARBUÉS
22,050,96,48,48,22050000000,BARBUÑALES
22,051,117,64,53,22051000000,BÁRCABO
22,052,1306,750,556,22052000000,BELVER DE CINCA
22,053,1168,600,568,22053000000,BENABARRE
22,054,2306,1245,1061,22054000000,BENASQUE
22,055,322,170,152,22055000000,BERBEGAL
22,057,482,253,229,22057000000,BIELSA
22,058,253,143,110,22058000000,BIERGE
22,059,1602,845,757,22059000000,BIESCAS
22,060,1577,865,712,22060000000,BINACED
22,061,10070,5320,4750,22061000000,BINÉFAR
22,062,183,100,83,22062000000,BISAURRI
22,063,186,97,89,22063000000,BISCARRUÉS
22,064,186,100,86,22064000000,BLECUA Y TORRES
22,066,1104,585,519,22066000000,BOLTAÑA
22,067,92,51,41,22067000000,BONANSA
22,068,87,49,38,22068000000,BORAU
22,069,599,327,272,22069000000,BROTO
22,072,242,144,98,22072000000,CALDEARENAS
22,074,463,246,217,22074000000,CAMPO
22,075,151,78,73,22075000000,CAMPORRÉLLS
22,076,337,184,153,22076000000,CANAL DE BERDÚN
22,077,418,227,191,22077000000,CANDASNOS
22,078,596,334,262,22078000000,CANFRANC
22,079,204,88,116,22079000000,CAPDESASO
22,080,360,187,173,22080000000,CAPELLA
22,081,291,167,124,22081000000,CASBAS DE HUESCA
22,082,328,173,155,22082000000,CASTEJÓN DEL PUENTE
22,083,478,254,224,22083000000,CASTEJÓN DE MONEGROS
22,084,833,420,413,22084000000,CASTEJÓN DE SOS
22,085,102,51,51,22085000000,CASTELFLORITE
22,086,242,134,108,22086000000,CASTIELLO DE JACA
22,087,96,60,36,22087000000,CASTIGALEU
22,088,162,84,78,22088000000,CASTILLAZUELO
22,089,324,173,151,22089000000,CASTILLONROY
22,090,128,71,57,22090000000,COLUNGO
22,094,130,71,59,22094000000,CHALAMERA
22,095,92,57,35,22095000000,CHÍA
22,096,396,208,188,22096000000,CHIMILLAS
22,099,673,350,323,22099000000,ESPLÚS
22,102,203,119,84,22102000000,ESTADA
22,103,840,424,416,22103000000,ESTADILLA
22,105,116,60,56,22105000000,ESTOPIÑÁN DEL CASTILLO
22,106,26,16,10,22106000000,FAGO
22,107,113,67,46,22107000000,FANLO
22,109,386,213,173,22109000000,FISCAL
22,110,886,453,433,22110000000,FONZ
22,111,158,86,72,22111000000,FORADADA DEL TOSCAR
22,112,15373,7858,7515,22112000000,FRAGA
22,113,600,318,282,22113000000,LA FUEVA (LA)
22,114,122,71,51,22114000000,GISTAÍN
22,115,391,203,188,22115000000,EL GRADO (EL)
22,116,1731,891,840,22116000000,GRAÑÉN
22,117,3415,1687,1728,22117000000,GRAUS
22,119,1450,746,704,22119000000,GURREA DE GÁLLEGO
22,122,76,40,36,22122000000,HOZ DE JACA
22,124,228,123,105,22124000000,HUERTO
22,125,54136,25912,28224,22125000000,HUESCA
22,126,108,60,48,22126000000,IBIECA
22,127,719,376,343,22127000000,IGRIÉS
22,128,188,97,91,22128000000,ILCHE
22,129,233,117,116,22129000000,ISÁBENA
22,130,13620,6658,6962,22130000000,JACA
22,131,102,61,41,22131000000,JASA
22,133,162,84,78,22133000000,LABUERDA
22,135,202,107,95,22135000000,LALUENGA
22,136,882,459,423,22136000000,LALUEZA
22,137,1173,626,547,22137000000,LANAJA
22,139,91,46,45,22139000000,LAPERDIGUERA
22,141,135,83,52,22141000000,LASCELLAS-PONZANO
22,142,138,69,69,22142000000,LASCUARRE
22,143,234,125,109,22143000000,LASPAÚLES
22,144,279,159,120,22144000000,LASPUÑA
22,149,350,194,156,22149000000,LOARRE
22,150,580,318,262,22150000000,LOPORZANO
22,151,99,49,50,22151000000,LOSCORRALES
22,155,66,37,29,22155000000,MONESMA Y CAJIGAR
22,156,468,247,221,22156000000,MONFLORITE-LASCASAS
22,157,241,140,101,22157000000,MONTANUY
22,158,17839,9020,8819,22158000000,MONZÓN
22,160,265,145,120,22160000000,NAVAL
22,162,172,79,93,22162000000,NOVALES
22,163,574,327,247,22163000000,NUENO
22,164,67,32,35,22164000000,OLVENA
22,165,519,270,249,22165000000,ONTIÑENA
22,167,638,366,272,22167000000,OSSO DE CINCA
22,168,32,16,16,22168000000,PALO
22,170,894,474,420,22170000000,PANTICOSA
22,172,726,424,302,22172000000,PEÑALBA
22,173,272,172,100,22173000000,LAS PEÑAS DE RIGLOS (LAS)
22,174,614,308,306,22174000000,PERALTA DE ALCOFEA
22,175,272,148,124,22175000000,PERALTA DE CALASANZ
22,176,225,107,118,22176000000,PERALTILLA
22,177,113,58,55,22177000000,PERARRÚA
22,178,137,79,58,22178000000,PERTUSA
22,181,96,48,48,22181000000,PIRACÉS
22,182,281,146,135,22182000000,PLAN
22,184,197,102,95,22184000000,POLEÑINO
22,186,235,113,122,22186000000,POZÁN DE VERO
22,187,419,219,200,22187000000,LA PUEBLA DE CASTRO (LA)
22,188,100,48,52,22188000000,PUENTE DE MONTAÑANA
22,189,222,116,106,22189000000,PUÉRTOLAS
22,190,173,96,77,22190000000,EL PUEYO DE ARAGUÁS (EL)
22,193,329,159,170,22193000000,PUEYO DE SANTA CRUZ
22,195,329,157,172,22195000000,QUICENA
22,197,523,276,247,22197000000,ROBRES
22,199,9423,4703,4720,22199000000,SABIÑÁNIGO
22,200,319,158,161,22200000000,SAHÚN
22,201,312,164,148,22201000000,SALAS ALTAS
22,202,191,95,96,22202000000,SALAS BAJAS
22,203,104,58,46,22203000000,SALILLAS
22,204,1554,784,770,22204000000,SALLENT DE GÁLLEGO
22,205,620,325,295,22205000000,SAN ESTEBAN DE LITERA
22,206,211,119,92,22206000000,SANGARRÉN
22,207,154,84,70,22207000000,SAN JUAN DE PLAN
22,208,251,127,124,22208000000,SANTA CILIA
22,209,192,109,83,22209000000,SANTA CRUZ DE LA SERÓS
22,212,77,48,29,22212000000,SANTALIESTRA Y SAN QUÍLEZ
22,213,4131,2144,1987,22213000000,SARIÑENA
22,214,148,70,78,22214000000,SECASTILLA
22,215,161,92,69,22215000000,SEIRA
22,217,486,261,225,22217000000,SENA
22,218,45,21,24,22218000000,SENÉS DE ALCUBIERRE
22,220,157,91,66,22220000000,SESA
22,221,126,65,61,22221000000,SESUÉ
22,222,686,385,301,22222000000,SIÉTAMO
22,223,91,50,41,22223000000,SOPEIRA
22,225,3393,1756,1637,22225000000,TAMARITE DE LITERA
22,226,929,460,469,22226000000,TARDIENTA
22,227,227,127,100,22227000000,TELLA-SIN
22,228,823,405,418,22228000000,TIERZ
22,229,125,70,55,22229000000,TOLVA
22,230,312,164,148,22230000000,TORLA-ORDESA
22,232,109,63,46,22232000000,TORRALBA DE ARAGÓN
22,233,97,50,47,22233000000,TORRE LA RIBERA
22,234,1121,585,536,22234000000,TORRENTE DE CINCA
22,235,82,47,35,22235000000,TORRES DE ALCANADRE
22,236,260,127,133,22236000000,TORRES DE BARBUÉS
22,239,108,68,40,22239000000,TRAMACED
22,242,62,37,25,22242000000,VALFARTA
22,243,60,39,21,22243000000,VALLE DE BARDAJÍ
22,244,60,38,22,22244000000,VALLE DE LIERP
22,245,497,264,233,22245000000,VELILLA DE CINCA
22,246,68,41,27,22246000000,BERANUY
22,247,40,25,15,22247000000,VIACAMP Y LITERA
22,248,139,82,57,22248000000,VICIÉN
22,249,176,91,85,22249000000,VILLANOVA
22,250,553,288,265,22250000000,VILLANÚA
22,251,341,188,153,22251000000,VILLANUEVA DE SIGENA
22,252,161,95,66,22252000000,YEBRA DE BASA
22,253,63,34,29,22253000000,YÉSERO
22,254,1784,926,858,22254000000,ZAIDÍN
22,901,799,432,367,22901000000,VALLE DE HECHO
22,902,276,144,132,22902000000,PUENTE LA REINA DE JACA
22,903,799,414,385,22903000000,SAN MIGUEL DEL CINCA
22,904,915,489,426,22904000000,LA SOTONERA (LA)
22,905,342,173,169,22905000000,LUPIÑÉN-ORTILLA
22,906,206,114,92,22906000000,SANTA MARÍA DE DULCIS
22,907,2297,1161,1136,22907000000,AÍNSA-SOBRARBE
22,908,240,134,106,22908000000,HOZ Y COSTEAN
22,909,408,221,187,22909000000,VENCILLÓN
23,001,958,501,457,23001000000,ALBANCHEZ DE MÁGINA
23,002,21587,10672,10915,23002000000,ALCALÁ LA REAL
23,003,10265,5048,5217,23003000000,ALCAUDETE
23,004,468,245,223,23004000000,ALDEAQUEMADA
23,005,35788,17469,18319,23005000000,ANDÚJAR
23,006,5349,2633,2716,23006000000,ARJONA
23,007,3539,1792,1747,23007000000,ARJONILLA
23,008,1680,852,828,23008000000,ARQUILLOS
23,009,15723,7796,7927,23009000000,BAEZA
23,010,17211,8535,8676,23010000000,BAILÉN
23,011,2558,1305,1253,23011000000,BAÑOS DE LA ENCINA
23,012,4984,2576,2408,23012000000,BEAS DE SEGURA
23,014,2967,1493,1474,23014000000,BEGÍJAR
23,015,1525,743,782,23015000000,BÉLMEZ DE LA MORALEDA
23,016,437,223,214,23016000000,BENATAE
23,017,1695,885,810,23017000000,CABRA DEL SANTO CRISTO
23,018,2643,1383,1260,23018000000,CAMBIL
23,019,1708,859,849,23019000000,CAMPILLO DE ARENAS
23,020,1780,935,845,23020000000,CANENA
23,021,606,311,295,23021000000,CARBONEROS
23,024,14801,7340,7461,23024000000,LA CAROLINA (LA)
23,025,3173,1610,1563,23025000000,CASTELLAR
23,026,3901,1930,1971,23026000000,CASTILLO DE LOCUBÍN
23,027,738,368,370,23027000000,CAZALILLA
23,028,7067,3432,3635,23028000000,CAZORLA
23,029,896,462,434,23029000000,CHICLANA DE SEGURA
23,030,1363,676,687,23030000000,CHILLUÉVAR
23,031,934,459,475,23031000000,ESCAÑUELA
23,032,604,300,304,23032000000,ESPELUY
23,033,1565,781,784,23033000000,FRAILES
23,034,3023,1524,1499,23034000000,FUENSANTA DE MARTOS
23,035,1352,703,649,23035000000,FUERTE DEL REY
23,037,561,298,263,23037000000,GÉNAVE
23,038,5175,2644,2531,23038000000,LA GUARDIA DE JAÉN (LA)
23,039,2782,1426,1356,23039000000,GUARROMÁN
23,040,1604,794,810,23040000000,LAHIGUERA
23,041,605,321,284,23041000000,HIGUERA DE CALATRAVA
23,042,348,180,168,23042000000,HINOJARES
23,043,574,278,296,23043000000,HORNOS
23,044,5559,2742,2817,23044000000,HUELMA
23,045,2436,1225,1211,23045000000,HUESA
23,046,2737,1376,1361,23046000000,IBROS
23,047,1881,943,938,23047000000,LA IRUELA (LA)
23,048,902,451,451,23048000000,IZNATORAF
23,049,1962,989,973,23049000000,JABALQUINTO
23,050,111888,53724,58164,23050000000,JAÉN
23,051,3319,1664,1655,23051000000,JAMILENA
23,052,1223,595,628,23052000000,JIMENA
23,053,11449,5705,5744,23053000000,JÓDAR
23,054,444,231,213,23054000000,LARVA
23,055,55096,26884,28212,23055000000,LINARES
23,056,3579,1830,1749,23056000000,LOPERA
23,057,806,392,414,23057000000,LUPIÓN
23,058,11375,5660,5715,23058000000,MANCHA REAL
23,059,6586,3290,3296,23059000000,MARMOLEJO
23,060,24363,12087,12276,23060000000,MARTOS
23,061,10041,5014,5027,23061000000,MENGÍBAR
23,062,1606,824,782,23062000000,MONTIZÓN
23,063,4427,2241,2186,23063000000,NAVAS DE SAN JUAN
23,064,1826,931,895,23064000000,NOALEJO
23,065,1735,869,866,23065000000,ORCERA
23,066,5325,2660,2665,23066000000,PEAL DE BECERRO
23,067,2822,1429,1393,23067000000,PEGALAJAR
23,069,5975,3008,2967,23069000000,PORCUNA
23,070,4594,2374,2220,23070000000,POZO ALCÓN
23,071,2168,1108,1060,23071000000,PUENTE DE GÉNAVE
23,072,2226,1113,1113,23072000000,LA PUERTA DE SEGURA (LA)
23,073,5015,2547,2468,23073000000,QUESADA
23,074,3453,1750,1703,23074000000,RUS
23,075,3823,1894,1929,23075000000,SABIOTE
23,076,866,451,415,23076000000,SANTA ELENA
23,077,657,345,312,23077000000,SANTIAGO DE CALATRAVA
23,079,4442,2285,2157,23079000000,SANTISTEBAN DEL PUERTO
23,080,2081,1063,1018,23080000000,SANTO TOMÉ
23,081,1710,844,866,23081000000,SEGURA DE LA SIERRA
23,082,2137,1083,1054,23082000000,SILES
23,084,1043,542,501,23084000000,SORIHUELA DEL GUADALIMAR
23,085,2434,1237,1197,23085000000,TORREBLASCOPEDRO
23,086,13871,6945,6926,23086000000,TORREDELCAMPO
23,087,13301,6563,6738,23087000000,TORREDONJIMENO
23,088,7108,3480,3628,23088000000,TORREPEROGIL
23,090,1349,697,652,23090000000,TORRES
23,091,746,391,355,23091000000,TORRES DE ALBÁNCHEZ
23,092,33810,16476,17334,23092000000,ÚBEDA
23,093,3566,1761,1805,23093000000,VALDEPEÑAS DE JAÉN
23,094,4238,2129,2109,23094000000,VILCHES
23,095,10344,5222,5122,23095000000,VILLACARRILLO
23,096,2964,1499,1465,23096000000,VILLANUEVA DE LA REINA
23,097,7933,4091,3842,23097000000,VILLANUEVA DEL ARZOBISPO
23,098,920,459,461,23098000000,VILLARDOMPARDO
23,099,6079,3059,3020,23099000000,LOS VILLARES (LOS)
23,101,383,208,175,23101000000,VILLARRODRIGO
23,901,1300,686,614,23901000000,CÁRCHELES
23,902,2605,1322,1283,23902000000,BEDMAR Y GARCÍEZ
23,903,4261,2179,2082,23903000000,VILLATORRES
23,904,2729,1415,1314,23904000000,SANTIAGO-PONTONES
23,905,2187,1102,1085,23905000000,ARROYO DEL OJANCO
24,001,182,102,80,24001000000,ACEBEDO
24,002,290,150,140,24002000000,ALGADEFE
24,003,593,302,291,24003000000,ALIJA DEL INFANTADO
24,004,626,350,276,24004000000,ALMANZA
24,005,331,192,139,24005000000,LA ANTIGUA (LA)
24,006,558,308,250,24006000000,ARDÓN
24,007,798,405,393,24007000000,ARGANZA
24,008,10321,4837,5484,24008000000,ASTORGA
24,009,261,147,114,24009000000,BALBOA
24,010,10047,4805,5242,24010000000,LA BAÑEZA (LA)
24,011,160,91,69,24011000000,BARJAS
24,012,300,173,127,24012000000,LOS BARRIOS DE LUNA (LOS)
24,014,8196,3934,4262,24014000000,BEMBIBRE
24,015,2367,1176,1191,24015000000,BENAVIDES
24,016,455,275,180,24016000000,BENUZA
24,017,524,269,255,24017000000,BERCIANOS DEL PÁRAMO
24,018,186,101,85,24018000000,BERCIANOS DEL REAL CAMINO
24,019,322,148,174,24019000000,BERLANGA DEL BIERZO
24,020,435,256,179,24020000000,BOCA DE HUÉRGANO
24,021,1804,922,882,24021000000,BOÑAR
24,022,304,167,137,24022000000,BORRENES
24,023,323,178,145,24023000000,BRAZUELO
24,024,683,359,324,24024000000,EL BURGO RANERO (EL)
24,025,294,172,122,24025000000,BURÓN
24,026,1076,561,515,24026000000,BUSTILLO DEL PÁRAMO
24,027,1316,691,625,24027000000,CABAÑAS RARAS
24,028,401,218,183,24028000000,CABREROS DEL RÍO
24,029,719,381,338,24029000000,CABRILLANES
24,030,4793,2363,2430,24030000000,CACABELOS
24,031,222,132,90,24031000000,CALZADA DEL COTO
24,032,109,55,54,24032000000,CAMPAZAS
24,033,200,113,87,24033000000,CAMPO DE VILLAVIDEL
24,034,4096,2033,2063,24034000000,CAMPONARAYA
24,036,283,156,127,24036000000,CANDÍN
24,037,337,191,146,24037000000,CÁRMENES
24,038,3431,1718,1713,24038000000,CARRACEDELO
24,039,2208,1112,1096,24039000000,CARRIZO
24,040,445,232,213,24040000000,CARROCERA
24,041,495,247,248,24041000000,CARUCEDO
24,042,65,39,26,24042000000,CASTILFALÉ
24,043,106,64,42,24043000000,CASTRILLO DE CABRERA
24,044,142,69,73,24044000000,CASTRILLO DE LA VALDUERNA
24,046,925,483,442,24046000000,CASTROCALBÓN
24,047,682,378,304,24047000000,CASTROCONTRIGO
24,049,1588,823,765,24049000000,CASTROPODAME
24,050,107,55,52,24050000000,CASTROTIERRA DE VALMADRIGAL
24,051,378,199,179,24051000000,CEA
24,052,144,84,60,24052000000,CEBANICO
24,053,435,238,197,24053000000,CEBRONES DEL RÍO
24,054,441,222,219,24054000000,CIMANES DE LA VEGA
24,055,742,405,337,24055000000,CIMANES DEL TEJAR
24,056,2951,1455,1496,24056000000,CISTIERNA
24,057,1436,714,722,24057000000,CONGOSTO
24,058,183,103,80,24058000000,CORBILLOS DE LOS OTEROS
24,059,849,431,418,24059000000,CORULLÓN
24,060,530,286,244,24060000000,CRÉMENES
24,061,2088,1053,1035,24061000000,CUADROS
24,062,138,77,61,24062000000,CUBILLAS DE LOS OTEROS
24,063,393,211,182,24063000000,CUBILLAS DE RUEDA
24,064,1741,910,831,24064000000,CUBILLOS DEL SIL
24,065,2677,1369,1308,24065000000,CHOZAS DE ABAJO
24,066,431,206,225,24066000000,DESTRIANA
24,067,623,335,288,24067000000,ENCINEDO
24,068,442,235,207,24068000000,LA ERCINA (LA)
24,069,33,21,12,24069000000,ESCOBAR DE CAMPOS
24,070,4112,2019,2093,24070000000,FABERO
24,071,1005,488,517,24071000000,FOLGOSO DE LA RIBERA
24,073,464,236,228,24073000000,FRESNO DE LA VEGA
24,074,77,50,27,24074000000,FUENTES DE CARBAJAL
24,076,1646,878,768,24076000000,GARRAFE DE TORÍO
24,077,246,119,127,24077000000,GORDALIZA DEL PINO
24,078,325,160,165,24078000000,GORDONCILLO
24,079,944,521,423,24079000000,GRADEFES
24,080,221,114,107,24080000000,GRAJAL DE CAMPOS
24,081,128,64,64,24081000000,GUSENDOS DE LOS OTEROS
24,082,961,480,481,24082000000,HOSPITAL DE ÓRBIGO
24,083,1083,561,522,24083000000,IGÜEÑA
24,084,143,72,71,24084000000,IZAGRE
24,086,240,131,109,24086000000,JOARILLA DE LAS MATAS
24,087,621,339,282,24087000000,LAGUNA DALGA
24,088,1050,535,515,24088000000,LAGUNA DE NEGRILLOS
24,089,121281,54837,66444,24089000000,LEÓN
24,090,361,188,173,24090000000,LUCILLO
24,091,568,316,252,24091000000,LUYEGO
24,092,798,420,378,24092000000,LLAMAS DE LA RIBERA
24,093,354,191,163,24093000000,MAGAZ DE CEPEDA
24,094,1654,841,813,24094000000,MANSILLA DE LAS MULAS
24,095,324,174,150,24095000000,MANSILLA MAYOR
24,096,120,76,44,24096000000,MARAÑA
24,097,224,114,110,24097000000,MATADEÓN DE LOS OTEROS
24,098,1258,649,609,24098000000,MATALLANA DE TORÍO
24,099,174,96,78,24099000000,MATANZA
24,100,872,478,394,24100000000,MOLINASECA
24,101,349,189,160,24101000000,MURIAS DE PAREDES
24,102,613,315,298,24102000000,NOCEDA DEL BIERZO
24,103,284,167,117,24103000000,OENCIA
24,104,257,137,120,24104000000,LAS OMAÑAS (LAS)
24,105,1880,968,912,24105000000,ONZONILLA
24,106,230,140,90,24106000000,OSEJA DE SAJAMBRE
24,107,241,144,97,24107000000,PAJARES DE LOS OTEROS
24,108,351,174,177,24108000000,PALACIOS DE LA VALDUERNA
24,109,867,479,388,24109000000,PALACIOS DEL SIL
24,110,1214,623,591,24110000000,PÁRAMO DEL SIL
24,112,270,161,109,24112000000,PERANZANES
24,113,354,182,172,24113000000,POBLADURA DE PELAYO GARCÍA
24,114,2880,1450,1430,24114000000,LA POLA DE GORDÓN (LA)
24,115,62963,29727,33236,24115000000,PONFERRADA
24,116,420,240,180,24116000000,POSADA DE VALDEÓN
24,117,405,195,210,24117000000,POZUELO DEL PÁRAMO
24,118,109,64,45,24118000000,PRADO DE LA GUZPEÑA
24,119,731,358,373,24119000000,PRIARANZA DEL BIERZO
24,120,347,202,145,24120000000,PRIORO
24,121,674,381,293,24121000000,PUEBLA DE LILLO
24,122,1406,729,677,24122000000,PUENTE DE DOMINGO FLÓREZ
24,123,724,397,327,24123000000,QUINTANA DEL CASTILLO
24,124,332,186,146,24124000000,QUINTANA DEL MARCO
24,125,416,221,195,24125000000,QUINTANA Y CONGOSTO
24,127,264,140,124,24127000000,REGUERAS DE ARRIBA
24,129,127,70,57,24129000000,REYERO
24,130,474,260,214,24130000000,RIAÑO
24,131,718,387,331,24131000000,RIEGO DE LA VEGA
24,132,603,341,262,24132000000,RIELLO
24,133,382,212,170,24133000000,RIOSECO DE TAPIA
24,134,3637,1801,1836,24134000000,LA ROBLA (LA)
24,136,505,257,248,24136000000,ROPERUELOS DEL PÁRAMO
24,137,1046,532,514,24137000000,SABERO
24,139,2456,1202,1254,24139000000,SAHAGÚN
24,141,92,54,38,24141000000,SAN ADRIÁN DEL VALLE
24,142,29961,14246,15715,24142000000,SAN ANDRÉS DEL RABANEDO
24,143,532,275,257,24143000000,SANCEDO
24,144,642,332,310,24144000000,SAN CRISTÓBAL DE LA POLANTERA
24,145,602,344,258,24145000000,SAN EMILIANO
24,146,253,132,121,24146000000,SAN ESTEBAN DE NOGALES
24,148,1761,905,856,24148000000,SAN JUSTO DE LA VEGA
24,149,177,94,83,24149000000,SAN MILLÁN DE LOS CABALLEROS
24,150,227,121,106,24150000000,SAN PEDRO BERCIANOS
24,151,496,257,239,24151000000,SANTA COLOMBA DE CURUEÑO
24,152,496,270,226,24152000000,SANTA COLOMBA DE SOMOZA
24,153,281,142,139,24153000000,SANTA CRISTINA DE VALMADRIGAL
24,154,1038,548,490,24154000000,SANTA ELENA DE JAMUZ
24,155,453,236,217,24155000000,SANTA MARÍA DE LA ISLA
24,156,212,117,95,24156000000,SANTA MARÍA DEL MONTE DE CEA
24,157,3041,1485,1556,24157000000,SANTA MARÍA DEL PÁRAMO
24,158,337,189,148,24158000000,SANTA MARÍA DE ORDÁS
24,159,1772,883,889,24159000000,SANTA MARINA DEL REY
24,160,732,390,342,24160000000,SANTAS MARTAS
24,161,364,205,159,24161000000,SANTIAGO MILLAS
24,162,2081,1047,1034,24162000000,SANTOVENIA DE LA VALDONCINA
24,163,5413,2683,2730,24163000000,SARIEGOS
24,164,395,194,201,24164000000,SENA DE LUNA
24,165,302,153,149,24165000000,SOBRADO
24,166,1487,783,704,24166000000,SOTO DE LA VEGA
24,167,729,369,360,24167000000,SOTO Y AMÍO
24,168,499,276,223,24168000000,TORAL DE LOS GUZMANES
24,169,2898,1459,1439,24169000000,TORENO
24,170,2026,1035,991,24170000000,TORRE DEL BIERZO
24,171,337,190,147,24171000000,TRABADELO
24,172,404,218,186,24172000000,TRUCHAS
24,173,973,495,478,24173000000,TURCIA
24,174,457,246,211,24174000000,URDIALES DEL PÁRAMO
24,175,2302,1199,1103,24175000000,VALDEFRESNO
24,176,308,167,141,24176000000,VALDEFUENTES DEL PÁRAMO
24,177,507,283,224,24177000000,VALDELUGUEROS
24,178,66,28,38,24178000000,VALDEMORA
24,179,288,167,121,24179000000,VALDEPIÉLAGO
24,180,1197,645,552,24180000000,VALDEPOLO
24,181,1524,786,738,24181000000,VALDERAS
24,182,425,220,205,24182000000,VALDERREY
24,183,831,459,372,24183000000,VALDERRUEDA
24,184,179,103,76,24184000000,VALDESAMARIO
24,185,502,242,260,24185000000,VAL DE SAN LORENZO
24,187,905,468,437,24187000000,VALDEVIMBRE
24,188,5185,2534,2651,24188000000,VALENCIA DE DON JUAN
24,189,7687,3969,3718,24189000000,VALVERDE DE LA VIRGEN
24,190,156,78,78,24190000000,VALVERDE-ENRIQUE
24,191,105,62,43,24191000000,VALLECILLO
24,193,384,213,171,24193000000,LA VECILLA (LA)
24,194,262,137,125,24194000000,VEGACERVERA
24,196,2016,1027,989,24196000000,VEGA DE ESPINAREDA
24,197,848,431,417,24197000000,VEGA DE INFANZONES
24,198,561,285,276,24198000000,VEGA DE VALCARCE
24,199,437,251,186,24199000000,VEGAQUEMADA
24,201,1157,659,498,24201000000,VEGAS DEL CONDADO
24,202,7845,3793,4052,24202000000,VILLABLINO
24,203,113,64,49,24203000000,VILLABRAZ
24,205,1222,627,595,24205000000,VILLADANGOS DEL PÁRAMO
24,206,1779,888,891,24206000000,TORAL DE LOS VADOS
24,207,284,148,136,24207000000,VILLADEMOR DE LA VEGA
24,209,2694,1289,1405,24209000000,VILLAFRANCA DEL BIERZO
24,210,661,373,288,24210000000,VILLAGATÓN
24,211,282,148,134,24211000000,VILLAMANDOS
24,212,1067,550,517,24212000000,VILLAMAÑÁN
24,213,162,87,75,24213000000,VILLAMARTÍN DE DON SANCHO
24,214,652,354,298,24214000000,VILLAMEJIL
24,215,134,69,65,24215000000,VILLAMOL
24,216,693,352,341,24216000000,VILLAMONTÁN DE LA VALDUERNA
24,217,127,71,56,24217000000,VILLAMORATIEL DE LAS MATAS
24,218,496,256,240,24218000000,VILLANUEVA DE LAS MANZANAS
24,219,532,292,240,24219000000,VILLAOBISPO DE OTERO
24,221,808,409,399,24221000000,VILLAQUEJIDA
24,222,18765,9309,9456,24222000000,VILLAQUILAMBRE
24,223,2908,1431,1477,24223000000,VILLAREJO DE ÓRBIGO
24,224,567,304,263,24224000000,VILLARES DE ÓRBIGO
24,225,1121,581,540,24225000000,VILLASABARIEGO
24,226,181,103,78,24226000000,VILLASELÁN
24,227,1886,979,907,24227000000,VILLATURIEL
24,228,612,335,277,24228000000,VILLAZALA
24,229,379,220,159,24229000000,VILLAZANZO DE VALDERADUEY
24,230,408,226,182,24230000000,ZOTES DEL PÁRAMO
24,901,894,467,427,24901000000,VILLAMANÍN
24,902,345,172,173,24902000000,VILLAORNATE Y CASTRO
25,001,167,87,80,25001000000,ABELLA DE LA CONCA
25,002,582,320,262,25002000000,ÀGER
25,003,5516,2773,2743,25003000000,AGRAMUNT
25,004,794,398,396,25004000000,ELS ALAMÚS (ELS)
25,005,322,158,164,25005000000,ALÀS I CERC
25,006,356,189,167,25006000000,L'ALBAGÉS (L')
25,007,2238,1142,1096,25007000000,ALBATÀRREC
25,008,1588,852,736,25008000000,ALBESA
25,009,764,388,376,25009000000,L'ALBI (L')
25,010,243,123,120,25010000000,ALCANÓ
25,011,9787,5071,4716,25011000000,ALCARRÀS
25,012,3495,1863,1632,25012000000,ALCOLETGE
25,013,2783,1450,1333,25013000000,ALFARRÀS
25,014,286,156,130,25014000000,ALFÉS
25,015,434,233,201,25015000000,ALGERRI
25,016,3012,1592,1420,25016000000,ALGUAIRE
25,017,282,153,129,25017000000,ALINS
25,019,6847,3685,3162,25019000000,ALMACELLES
25,020,307,172,135,25020000000,ALMATRET
25,021,3379,1811,1568,25021000000,ALMENAR
25,022,114,66,48,25022000000,ALÒS DE BALAGUER
25,023,6394,3206,3188,25023000000,ALPICAT
25,024,447,257,190,25024000000,ALT ÀNEU
25,025,1921,1001,920,25025000000,NAUT ARAN
25,027,1361,686,675,25027000000,ANGLESOLA
25,029,2109,1078,1031,25029000000,ARBECA
25,030,163,96,67,25030000000,EL PONT DE BAR (EL)
25,031,71,49,22,25031000000,ARRES
25,032,77,41,36,25032000000,ARSÈGUEL
25,033,1512,802,710,25033000000,ARTESA DE LLEIDA
25,034,3504,1813,1691,25034000000,ARTESA DE SEGRE
25,035,445,226,219,25035000000,LA SENTIU DE SIÓ (LA)
25,036,217,111,106,25036000000,ASPA
25,037,445,246,199,25037000000,LES AVELLANES I SANTA LINYA (LES)
25,038,2557,1349,1208,25038000000,AITONA
25,039,349,188,161,25039000000,BAIX PALLARS
25,040,17649,9053,8596,25040000000,BALAGUER
25,041,929,518,411,25041000000,BARBENS
25,042,225,118,107,25042000000,LA BARONIA DE RIALB (LA)
25,043,1090,587,503,25043000000,LA VALL DE BOÍ (LA)
25,044,221,120,101,25044000000,BASSELLA
25,045,70,38,32,25045000000,BAUSEN
25,046,510,248,262,25046000000,BELIANES
25,047,1231,626,605,25047000000,BELLCAIRE D'URGELL
25,048,2378,1195,1183,25048000000,BELL-LLOC D'URGELL
25,049,176,94,82,25049000000,BELLMUNT D'URGELL
25,050,5150,2726,2424,25050000000,BELLPUIG
25,051,2250,1155,1095,25051000000,BELLVER DE CERDANYA
25,052,2263,1160,1103,25052000000,BELLVÍS
25,053,1579,831,748,25053000000,BENAVENT DE SEGRIÀ
25,055,184,101,83,25055000000,BIOSCA
25,056,258,138,120,25056000000,BOVERA
25,057,278,156,122,25057000000,ES BÒRDES (ES)
25,058,6215,3171,3044,25058000000,LES BORGES BLANQUES (LES)
25,059,1137,555,582,25059000000,BOSSÒST
25,060,61,28,33,25060000000,CABANABONA
25,061,99,50,49,25061000000,CABÓ
25,062,786,402,384,25062000000,CAMARASA
25,063,97,50,47,25063000000,CANEJAN
25,064,142,73,69,25064000000,CASTELLAR DE LA RIBERA
25,067,893,466,427,25067000000,CASTELLDANS
25,068,706,372,334,25068000000,CASTELLNOU DE SEANA
25,069,531,279,252,25069000000,CASTELLÓ DE FARFANYA
25,070,989,509,480,25070000000,CASTELLSERÀ
25,071,44,29,15,25071000000,CAVA
25,072,9453,4820,4633,25072000000,CERVERA
25,073,645,351,294,25073000000,CERVIÀ DE LES GARRIGUES
25,074,188,100,88,25074000000,CIUTADILLA
25,075,158,83,75,25075000000,CLARIANA DE CARDENER
25,076,155,88,67,25076000000,EL COGUL (EL)
25,077,568,296,272,25077000000,COLL DE NARGÓ
25,078,1486,809,677,25078000000,CORBINS
25,079,344,180,164,25079000000,CUBELLS
25,081,324,164,160,25081000000,L'ESPLUGA CALBA (L')
25,082,386,209,177,25082000000,ESPOT
25,085,164,84,80,25085000000,ESTARÀS
25,086,874,434,440,25086000000,ESTERRI D'ÀNEU
25,087,61,31,30,25087000000,ESTERRI DE CARDÓS
25,088,133,75,58,25088000000,ESTAMARIU
25,089,124,69,55,25089000000,FARRERA
25,092,155,89,66,25092000000,LA FLORESTA (LA)
25,093,780,390,390,25093000000,FONDARELLA
25,094,179,100,79,25094000000,FORADADA
25,096,1223,611,612,25096000000,LA FULIOLA (LA)
25,097,87,46,41,25097000000,FULLEDA
25,098,257,125,132,25098000000,GAVET DE LA CONCA
25,099,1902,967,935,25099000000,GOLMÉS
25,100,230,126,104,25100000000,GÓSOL
25,101,750,427,323,25101000000,LA GRANADELLA (LA)
25,102,927,535,392,25102000000,LA GRANJA D'ESCARP (LA)
25,103,149,85,64,25103000000,GRANYANELLA
25,104,152,81,71,25104000000,GRANYENA DE SEGARRA
25,105,157,96,61,25105000000,GRANYENA DE LES GARRIGUES
25,109,255,139,116,25109000000,GUIMERÀ
25,110,7603,4033,3570,25110000000,GUISSONA
25,111,131,77,54,25111000000,GUIXERS
25,112,332,179,153,25112000000,IVARS DE NOGUERA
25,113,1607,868,739,25113000000,IVARS D'URGELL
25,114,99,56,43,25114000000,IVORRA
25,115,1061,578,483,25115000000,ISONA I CONCA DELLÀ
25,118,382,197,185,25118000000,JUNCOSA
25,119,3478,1845,1633,25119000000,JUNEDA
25,120,143094,71273,71821,25120000000,LLEIDA
25,121,994,510,484,25121000000,LES
25,122,2744,1387,1357,25122000000,LINYOLA
25,123,254,131,123,25123000000,LLADORRE
25,124,185,100,85,25124000000,LLADURS
25,125,419,226,193,25125000000,LLARDECANS
25,126,343,171,172,25126000000,LLAVORSÍ
25,127,292,172,120,25127000000,LLES DE CERDANYA
25,128,133,75,58,25128000000,LLIMIANA
25,129,212,122,90,25129000000,LLOBERA
25,130,240,120,120,25130000000,MALDÀ
25,131,563,314,249,25131000000,MASSALCOREIG
25,132,215,111,104,25132000000,MASSOTERES
25,133,908,504,404,25133000000,MAIALS
25,134,774,407,367,25134000000,MENÀRGUENS
25,135,1366,703,663,25135000000,MIRALCAMP
25,136,102,48,54,25136000000,LA MOLSOSA (LA)
25,137,15037,7747,7290,25137000000,MOLLERUSSA
25,138,633,328,305,25138000000,MONTGAI
25,139,631,332,299,25139000000,MONTELLÀ I MARTINET
25,140,1093,586,507,25140000000,MONTFERRER I CASTELLBÒ
25,141,183,105,78,25141000000,MONTOLIU DE SEGARRA
25,142,483,250,233,25142000000,MONTOLIU DE LLEIDA
25,143,91,44,47,25143000000,MONTORNÈS DE SEGARRA
25,145,94,53,41,25145000000,NALEC
25,146,315,157,158,25146000000,NAVÈS
25,148,248,141,107,25148000000,ODÈN
25,149,1864,921,943,25149000000,OLIANA
25,150,198,106,92,25150000000,OLIOLA
25,151,995,514,481,25151000000,OLIUS
25,152,164,92,72,25152000000,LES OLUGES (LES)
25,153,197,105,92,25153000000,ELS OMELLONS (ELS)
25,154,120,66,54,25154000000,ELS OMELLS DE NA GAIA (ELS)
25,155,797,409,388,25155000000,ORGANYÀ
25,156,1083,543,540,25156000000,OS DE BALAGUER
25,157,197,100,97,25157000000,OSSÓ DE SIÓ
25,158,2188,1084,1104,25158000000,EL PALAU D'ANGLESOLA (EL)
25,161,436,228,208,25161000000,CONCA DE DALT
25,163,275,155,120,25163000000,LA COMA I LA PEDRA (LA)
25,164,428,247,181,25164000000,PENELLES
25,165,345,175,170,25165000000,PERAMOLA
25,166,194,108,86,25166000000,PINELL DE SOLSONÈS
25,167,280,153,127,25167000000,PINÓS
25,168,655,335,320,25168000000,EL POAL (EL)
25,169,201,111,90,25169000000,LA POBLA DE CÉRVOLES (LA)
25,170,289,151,138,25170000000,BELLAGUARDA
25,171,3035,1524,1511,25171000000,LA POBLA DE SEGUR (LA)
25,172,2710,1401,1309,25172000000,PONTS
25,173,2371,1199,1172,25173000000,EL PONT DE SUERT (EL)
25,174,753,431,322,25174000000,LA PORTELLA (LA)
25,175,254,138,116,25175000000,PRATS I SANSOR
25,176,403,209,194,25176000000,PREIXANA
25,177,411,208,203,25177000000,PREIXENS
25,179,269,129,140,25179000000,PRULLANS
25,180,257,131,126,25180000000,PUIGGRÒS
25,181,260,147,113,25181000000,PUIGVERD D'AGRAMUNT
25,182,1397,722,675,25182000000,PUIGVERD DE LLEIDA
25,183,669,336,333,25183000000,RIALP
25,185,938,479,459,25185000000,RIBERA D'URGELLET
25,186,267,128,139,25186000000,RINER
25,189,3329,1713,1616,25189000000,ROSSELLÓ
25,190,348,190,158,25190000000,SALÀS DE PALLARS
25,191,391,202,189,25191000000,SANAÜJA
25,192,1152,604,548,25192000000,SANT GUIM DE FREIXENET
25,193,1002,489,513,25193000000,SANT LLORENÇ DE MORUNYS
25,194,489,258,231,25194000000,SANT RAMON
25,196,129,82,47,25196000000,SANT ESTEVE DE LA SARGA
25,197,200,102,98,25197000000,SANT GUIM DE LA PLANA
25,200,387,214,173,25200000000,SARROCA DE LLEIDA
25,201,119,67,52,25201000000,SARROCA DE BELLERA
25,202,160,93,67,25202000000,SENTERADA
25,203,12568,6131,6437,25203000000,LA SEU D'URGELL (LA)
25,204,1893,1022,871,25204000000,SERÒS
25,205,766,407,359,25205000000,SIDAMON
25,206,321,171,150,25206000000,EL SOLERÀS (EL)
25,207,9171,4550,4621,25207000000,SOLSONA
25,208,440,230,210,25208000000,SORIGUERA
25,209,2211,1087,1124,25209000000,SORT
25,210,1855,980,875,25210000000,SOSES
25,211,885,495,390,25211000000,SUDANELL
25,212,331,180,151,25212000000,SUNYER
25,215,591,374,217,25215000000,TALARN
25,216,277,153,124,25216000000,TALAVERA
25,217,18268,9073,9195,25217000000,TÀRREGA
25,218,117,58,59,25218000000,TARRÉS
25,219,180,96,84,25219000000,TARROJA DE SEGARRA
25,220,1341,696,645,25220000000,TÉRMENS
25,221,144,71,73,25221000000,TÍRVIA
25,222,67,33,34,25222000000,TIURANA
25,223,1201,609,592,25223000000,TORÀ
25,224,142,72,70,25224000000,ELS TORMS (ELS)
25,225,857,464,393,25225000000,TORNABOUS
25,226,294,154,140,25226000000,TORREBESSES
25,227,794,392,402,25227000000,LA TORRE DE CABDELLA (LA)
25,228,4852,2466,2386,25228000000,TORREFARRERA
25,230,2186,1143,1043,25230000000,TORREGROSSA
25,231,751,445,306,25231000000,TORRELAMEU
25,232,2285,1197,1088,25232000000,TORRES DE SEGRE
25,233,405,210,195,25233000000,TORRE-SERONA
25,234,5961,2937,3024,25234000000,TREMP
25,238,222,115,107,25238000000,VALLBONA DE LES MONGES
25,239,792,412,380,25239000000,LES VALLS DE VALIRA (LES)
25,240,1990,1004,986,25240000000,VALLFOGONA DE BALAGUER
25,242,884,415,469,25242000000,VERDÚ
25,243,5765,2928,2837,25243000000,VIELHA E MIJARAN
25,244,621,332,289,25244000000,VILAGRASSA
25,245,505,280,225,25245000000,VILALLER
25,247,167,92,75,25247000000,VILAMÒS
25,248,1183,592,591,25248000000,VILANOVA DE BELLPUIG
25,249,196,95,101,25249000000,VILANOVA DE L'AGUDA
25,250,442,285,157,25250000000,VILANOVA DE MEIÀ
25,251,1045,563,482,25251000000,VILANOVA DE SEGRIÀ
25,252,766,386,380,25252000000,VILA-SANA
25,253,190,99,91,25253000000,EL VILOSELL (EL)
25,254,1090,595,495,25254000000,VILANOVA DE LA BARCA
25,255,445,234,211,25255000000,VINAIXA
25,901,379,208,171,25901000000,VALL DE CARDÓS
25,902,655,340,315,25902000000,SANT MARTÍ DE RIUCORB
25,903,285,156,129,25903000000,LA GUINGUETA D'ÀNEU (LA)
25,904,179,99,80,25904000000,CASTELL DE MUR
25,905,457,237,220,25905000000,RIBERA D'ONDARA
25,906,270,150,120,25906000000,LES VALLS D'AGUILAR (LES)
25,907,612,329,283,25907000000,TORREFETA I FLOREJACS
25,908,255,148,107,25908000000,FÍGOLS I ALINYÀ
25,909,181,91,90,25909000000,LA VANSA I FÓRNOLS (LA)
25,910,125,74,51,25910000000,JOSA I TUIXÉN
25,911,515,279,236,25911000000,ELS PLANS DE SIÓ (ELS)
25,912,1108,590,518,25912000000,GIMENELLS I EL PLA DE LA FONT
25,913,95,53,42,25913000000,RIU DE CERDANYA
26,001,258,146,112,26001000000,ÁBALOS
26,002,1228,665,563,26002000000,AGONCILLO
26,003,428,219,209,26003000000,AGUILAR DEL RÍO ALHAMA
26,004,90,55,35,26004000000,AJAMIL DE CAMEROS
26,005,3738,1921,1817,26005000000,ALBELDA DE IREGUA
26,006,2628,1348,1280,26006000000,ALBERITE
26,007,669,347,322,26007000000,ALCANADRE
26,008,2726,1419,1307,26008000000,ALDEANUEVA DE EBRO
26,009,474,241,233,26009000000,ALESANCO
26,010,98,55,43,26010000000,ALESÓN
26,011,9823,4921,4902,26011000000,ALFARO
26,012,39,25,14,26012000000,ALMARZA DE CAMEROS
26,013,435,244,191,26013000000,ANGUCIANA
26,014,499,274,225,26014000000,ANGUIANO
26,015,251,135,116,26015000000,ARENZANA DE ABAJO
26,016,33,23,10,26016000000,ARENZANA DE ARRIBA
26,017,436,216,220,26017000000,ARNEDILLO
26,018,15201,7587,7614,26018000000,ARNEDO
26,019,582,307,275,26019000000,ARRÚBAL
26,020,795,425,370,26020000000,AUSEJO
26,021,4834,2435,2399,26021000000,AUTOL
26,022,215,117,98,26022000000,AZOFRA
26,023,496,251,245,26023000000,BADARÁN
26,024,201,109,92,26024000000,BAÑARES
26,025,84,52,32,26025000000,BAÑOS DE RIOJA
26,026,1608,814,794,26026000000,BAÑOS DE RÍO TOBÍA
26,027,139,88,51,26027000000,BERCEO
26,028,163,86,77,26028000000,BERGASA
26,029,39,21,18,26029000000,BERGASILLAS BAJERA
26,030,26,13,13,26030000000,BEZARES
26,031,97,49,48,26031000000,BOBADILLA
26,032,43,27,16,26032000000,BRIEVA DE CAMEROS
26,033,182,91,91,26033000000,BRIÑAS
26,034,739,388,351,26034000000,BRIONES
26,035,23,15,8,26035000000,CABEZÓN DE CAMEROS
26,036,24994,12250,12744,26036000000,CALAHORRA
26,037,174,95,79,26037000000,CAMPROVÍN
26,038,81,55,26,26038000000,CANALES DE LA SIERRA
26,039,50,30,20,26039000000,CANILLAS DE RÍO TUERTO
26,040,92,51,41,26040000000,CAÑAS
26,041,132,72,60,26041000000,CÁRDENAS
26,042,1062,531,531,26042000000,CASALARREINA
26,043,385,177,208,26043000000,CASTAÑARES DE RIOJA
26,044,62,34,28,26044000000,CASTROVIEJO
26,045,10,4,6,26045000000,CELLORIGO
26,046,2067,1063,1004,26046000000,CENICERO
26,047,2262,1163,1099,26047000000,CERVERA DEL RÍO ALHAMA
26,048,22,11,11,26048000000,CIDAMÓN
26,049,207,105,102,26049000000,CIHURI
26,050,198,123,75,26050000000,CIRUEÑA
26,051,296,173,123,26051000000,CLAVIJO
26,052,153,76,77,26052000000,CORDOVÍN
26,053,283,142,141,26053000000,CORERA
26,054,304,174,130,26054000000,CORNAGO
26,055,38,24,14,26055000000,CORPORALES
26,056,566,297,269,26056000000,CUZCURRITA DE RÍO TIRÓN
26,057,60,38,22,26057000000,DAROCA DE RIOJA
26,058,174,113,61,26058000000,ENCISO
26,059,1637,858,779,26059000000,ENTRENA
26,060,93,55,38,26060000000,ESTOLLO
26,061,2080,1078,1002,26061000000,EZCARAY
26,062,94,55,39,26062000000,FONCEA
26,063,130,84,46,26063000000,FONZALECHE
26,064,3259,1630,1629,26064000000,FUENMAYOR
26,065,89,55,34,26065000000,GALBÁRRULI
26,066,394,199,195,26066000000,GALILEA
26,067,17,10,7,26067000000,GALLINERO DE CAMEROS
26,068,112,59,53,26068000000,GIMILEO
26,069,235,130,105,26069000000,GRAÑÓN
26,070,170,92,78,26070000000,GRÁVALOS
26,071,11763,5798,5965,26071000000,HARO
26,072,325,167,158,26072000000,HERCE
26,073,109,58,51,26073000000,HERRAMÉLLURI
26,074,133,72,61,26074000000,HERVÍAS
26,075,441,231,210,26075000000,HORMILLA
26,076,131,70,61,26076000000,HORMILLEJA
26,077,15,8,7,26077000000,HORNILLOS DE CAMEROS
26,078,96,57,39,26078000000,HORNOS DE MONCALVILLO
26,079,858,475,383,26079000000,HUÉRCANOS
26,080,648,366,282,26080000000,IGEA
26,081,23,10,13,26081000000,JALÓN DE CAMEROS
26,082,115,64,51,26082000000,LAGUNA DE CAMEROS
26,083,394,218,176,26083000000,LAGUNILLA DEL JUBERA
26,084,11321,5666,5655,26084000000,LARDERO
26,086,16,12,4,26086000000,LEDESMA DE LA COGOLLA
26,087,246,122,124,26087000000,LEIVA
26,088,40,24,16,26088000000,LEZA DE RÍO LEZA
26,089,150583,71340,79243,26089000000,LOGROÑO
26,091,145,100,45,26091000000,LUMBRERAS DE CAMEROS
26,092,108,67,41,26092000000,MANJARRÉS
26,093,60,44,16,26093000000,MANSILLA DE LA SIERRA
26,094,58,37,21,26094000000,MANZANARES DE RIOJA
26,095,86,52,34,26095000000,MATUTE
26,096,350,190,160,26096000000,MEDRANO
26,098,100,57,43,26098000000,MUNILLA
26,099,1643,833,810,26099000000,MURILLO DE RÍO LEZA
26,100,57,37,20,26100000000,MURO DE AGUAS
26,101,40,22,18,26101000000,MURO EN CAMEROS
26,102,8059,3994,4065,26102000000,NÁJERA
26,103,1329,720,609,26103000000,NALDA
26,104,8,7,1,26104000000,NAVAJÚN
26,105,3040,1529,1511,26105000000,NAVARRETE
26,106,83,50,33,26106000000,NESTARES
26,107,87,54,33,26107000000,NIEVA DE CAMEROS
26,108,318,195,123,26108000000,OCÓN
26,109,87,51,36,26109000000,OCHÁNDURI
26,110,172,102,70,26110000000,OJACASTRO
26,111,312,169,143,26111000000,OLLAURI
26,112,222,136,86,26112000000,ORTIGOSA DE CAMEROS
26,113,27,22,5,26113000000,PAZUENGOS
26,114,89,54,35,26114000000,PEDROSO
26,115,25,14,11,26115000000,PINILLOS
26,117,3817,1985,1832,26117000000,PRADEJÓN
26,118,67,37,30,26118000000,PRADILLO
26,119,211,115,96,26119000000,PRÉJANO
26,120,2151,1155,996,26120000000,QUEL
26,121,33,25,8,26121000000,RABANERA
26,122,149,86,63,26122000000,EL RASILLO DE CAMEROS (EL)
26,123,148,87,61,26123000000,EL REDAL (EL)
26,124,1041,540,501,26124000000,RIBAFRECHA
26,125,4021,2092,1929,26125000000,RINCÓN DE SOTO
26,126,27,17,10,26126000000,ROBRES DEL CASTILLO
26,127,202,114,88,26127000000,RODEZNO
26,128,130,74,56,26128000000,SAJAZARRA
26,129,1097,582,515,26129000000,SAN ASENSIO
26,130,214,144,70,26130000000,SAN MILLÁN DE LA COGOLLA
26,131,35,25,10,26131000000,SAN MILLÁN DE YÉCORA
26,132,126,79,47,26132000000,SAN ROMÁN DE CAMEROS
26,134,98,57,41,26134000000,SANTA COLOMA
26,135,198,119,79,26135000000,SANTA ENGRACIA DEL JUBERA
26,136,117,67,50,26136000000,SANTA EULALIA BAJERA
26,138,6283,3135,3148,26138000000,SANTO DOMINGO DE LA CALZADA
26,139,63,33,30,26139000000,SAN TORCUATO
26,140,280,150,130,26140000000,SANTURDE DE RIOJA
26,141,101,60,41,26141000000,SANTURDEJO
26,142,1010,535,475,26142000000,SAN VICENTE DE LA SONSIERRA
26,143,603,333,270,26143000000,SOJUELA
26,144,221,124,97,26144000000,SORZANO
26,145,260,143,117,26145000000,SOTÉS
26,146,86,50,36,26146000000,SOTO EN CAMEROS
26,147,41,20,21,26147000000,TERROBA
26,148,171,89,82,26148000000,TIRGO
26,149,46,26,20,26149000000,TOBÍA
26,150,122,71,51,26150000000,TORMANTOS
26,151,434,243,191,26151000000,TORRECILLA EN CAMEROS
26,152,54,32,22,26152000000,TORRECILLA SOBRE ALESANCO
26,153,9,7,2,26153000000,TORRE EN CAMEROS
26,154,8,7,1,26154000000,TORREMONTALBO
26,155,141,75,66,26155000000,TREVIANA
26,157,356,178,178,26157000000,TRICIO
26,158,356,191,165,26158000000,TUDELILLA
26,160,984,505,479,26160000000,URUÑUELA
26,161,12,9,3,26161000000,VALDEMADERA
26,162,137,81,56,26162000000,VALGAÑÓN
26,163,194,99,95,26163000000,VENTOSA
26,164,51,30,21,26164000000,VENTROSA
26,165,378,219,159,26165000000,VIGUERA
26,166,169,95,74,26166000000,VILLALBA DE RIOJA
26,167,72,46,26,26167000000,VILLALOBAR DE RIOJA
26,168,8954,4494,4460,26168000000,VILLAMEDIANA DE IREGUA
26,169,74,45,29,26169000000,VILLANUEVA DE CAMEROS
26,170,616,332,284,26170000000,EL VILLAR DE ARNEDO (EL)
26,171,153,96,57,26171000000,VILLAR DE TORRE
26,172,28,22,6,26172000000,VILLAREJO
26,173,3,2,1,26173000000,VILLARROYA
26,174,136,79,57,26174000000,VILLARTA-QUINTANA
26,175,42,28,14,26175000000,VILLAVELAYO
26,176,76,44,32,26176000000,VILLAVERDE DE RIOJA
26,177,348,223,125,26177000000,VILLOSLADA DE CAMEROS
26,178,73,47,26,26178000000,VINIEGRA DE ABAJO
26,179,41,28,13,26179000000,VINIEGRA DE ARRIBA
26,180,259,134,125,26180000000,ZARRATÓN
26,181,13,9,4,26181000000,ZARZOSA
26,183,86,44,42,26183000000,ZORRAQUÍN
27,001,2203,1078,1125,27001000000,ABADÍN
27,002,1553,745,808,27002000000,ALFOZ
27,003,1887,929,958,27003000000,ANTAS DE ULLA
27,004,1153,613,540,27004000000,BALEIRA
27,005,3020,1468,1552,27005000000,BARREIROS
27,006,2711,1359,1352,27006000000,BECERREÁ
27,007,2925,1468,1457,27007000000,BEGONTE
27,008,1405,708,697,27008000000,BÓVEDA
27,009,2080,1045,1035,27009000000,CARBALLEDO
27,010,5015,2506,2509,27010000000,CASTRO DE REI
27,011,2548,1307,1241,27011000000,CASTROVERDE
27,012,1209,703,506,27012000000,CERVANTES
27,013,4200,2057,2143,27013000000,CERVO
27,014,3396,1753,1643,27014000000,O CORGO (O)
27,015,4257,2091,2166,27015000000,COSPEITO
27,016,8006,3887,4119,27016000000,CHANTADA
27,017,1004,526,478,27017000000,FOLGOSO DO COUREL
27,018,3186,1668,1518,27018000000,A FONSAGRADA (A)
27,019,10163,4934,5229,27019000000,FOZ
27,020,3616,1845,1771,27020000000,FRIOL
27,021,1734,851,883,27021000000,XERMADE
27,022,5194,2613,2581,27022000000,GUITIRIZ
27,023,2551,1304,1247,27023000000,GUNTÍN
27,024,1524,780,744,27024000000,O INCIO (O)
27,025,3330,1722,1608,27025000000,XOVE
27,026,2492,1274,1218,27026000000,LÁNCARA
27,027,2115,1031,1084,27027000000,LOURENZÁ
27,028,98214,45397,52817,27028000000,LUGO
27,029,1753,882,871,27029000000,MEIRA
27,030,3439,1620,1819,27030000000,MONDOÑEDO
27,031,18234,8669,9565,27031000000,MONFORTE DE LEMOS
27,032,3593,1783,1810,27032000000,MONTERROSO
27,033,600,306,294,27033000000,MURAS
27,034,988,545,443,27034000000,NAVIA DE SUARNA
27,035,240,134,106,27035000000,NEGUEIRA DE MUÑIZ
27,037,958,507,451,27037000000,AS NOGAIS (AS)
27,038,980,506,474,27038000000,OUROL
27,039,5359,2745,2614,27039000000,OUTEIRO DE REI
27,040,3346,1694,1652,27040000000,PALAS DE REI
27,041,2423,1196,1227,27041000000,PANTÓN
27,042,1638,828,810,27042000000,PARADELA
27,043,1305,648,657,27043000000,O PÁRAMO (O)
27,044,2810,1416,1394,27044000000,A PASTORIZA (A)
27,045,909,495,414,27045000000,PEDRAFITA DO CEBREIRO
27,046,1582,797,785,27046000000,POL
27,047,1565,774,791,27047000000,A POBRA DO BROLLÓN (A)
27,048,2126,1026,1100,27048000000,A PONTENOVA (A)
27,049,1345,693,652,27049000000,PORTOMARÍN
27,050,3099,1485,1614,27050000000,QUIROGA
27,051,9828,4625,5203,27051000000,RIBADEO
27,052,914,463,451,27052000000,RIBAS DE SIL
27,053,497,263,234,27053000000,RIBEIRA DE PIQUÍN
27,054,1200,608,592,27054000000,RIOTORTO
27,055,1210,643,567,27055000000,SAMOS
27,056,1503,741,762,27056000000,RÁBADE
27,057,13221,6452,6769,27057000000,SARRIA
27,058,3504,1767,1737,27058000000,O SAVIÑAO (O)
27,059,2178,1056,1122,27059000000,SOBER
27,060,2657,1283,1374,27060000000,TABOADA
27,061,1107,542,565,27061000000,TRABADA
27,062,622,302,320,27062000000,TRIACASTELA
27,063,1890,901,989,27063000000,O VALADOURO (O)
27,064,1613,789,824,27064000000,O VICEDO (O)
27,065,13870,6712,7158,27065000000,VILALBA
27,066,15221,7462,7759,27066000000,VIVEIRO
27,901,2484,1307,1177,27901000000,BARALLA
27,902,9454,4756,4698,27902000000,BURELA
28,001,67,34,33,28001000000,LA ACEBEDA (LA)
28,002,4779,2483,2296,28002000000,AJALVIR
28,003,274,144,130,28003000000,ALAMEDA DEL VALLE
28,004,10322,5069,5253,28004000000,EL ÁLAMO (EL)
28,005,199184,96342,102842,28005000000,ALCALÁ DE HENARES
28,006,119416,56903,62513,28006000000,ALCOBENDAS
28,007,171772,82226,89546,28007000000,ALCORCÓN
28,008,3408,1743,1665,28008000000,ALDEA DEL FRESNO
28,009,20991,10279,10712,28009000000,ALGETE
28,010,15312,7513,7799,28010000000,ALPEDRETE
28,011,684,337,347,28011000000,AMBITE
28,012,1379,719,660,28012000000,ANCHUELO
28,013,60668,29482,31186,28013000000,ARANJUEZ
28,014,58990,29449,29541,28014000000,ARGANDA DEL REY
28,015,35972,17885,18087,28015000000,ARROYOMOLINOS
28,016,104,60,44,28016000000,EL ATAZAR (EL)
28,017,1872,966,906,28017000000,BATRES
28,018,6277,3128,3149,28018000000,BECERRIL DE LA SIERRA
28,019,1840,950,890,28019000000,BELMONTE DE TAJO
28,020,217,121,96,28020000000,BERZOSA DEL LOZOYA
28,021,802,412,390,28021000000,EL BERRUECO (EL)
28,022,64742,31617,33125,28022000000,BOADILLA DEL MONTE
28,023,8424,4201,4223,28023000000,EL BOALO (EL)
28,024,212,128,84,28024000000,BRAOJOS
28,025,543,313,230,28025000000,BREA DE TAJO
28,026,11014,5366,5648,28026000000,BRUNETE
28,027,1967,957,1010,28027000000,BUITRAGO DEL LOZOYA
28,028,2743,1354,1389,28028000000,BUSTARVIEJO
28,029,939,490,449,28029000000,CABANILLAS DE LA SIERRA
28,030,2882,1413,1469,28030000000,LA CABRERA (LA)
28,031,3173,1653,1520,28031000000,CADALSO DE LOS VIDRIOS
28,032,7792,3947,3845,28032000000,CAMARMA DE ESTERUELAS
28,033,6781,3429,3352,28033000000,CAMPO REAL
28,034,460,241,219,28034000000,CANENCIA
28,035,2273,1147,1126,28035000000,CARABAÑA
28,036,4062,2089,1973,28036000000,CASARRUBUELOS
28,037,2097,1049,1048,28037000000,CENICIENTOS
28,038,7648,3776,3872,28038000000,CERCEDILLA
28,039,164,95,69,28039000000,CERVERA DE BUITRAGO
28,040,25866,13030,12836,28040000000,CIEMPOZUELOS
28,041,7698,3766,3932,28041000000,COBEÑA
28,042,1947,1012,935,28042000000,COLMENAR DEL ARROYO
28,043,8649,4397,4252,28043000000,COLMENAR DE OREJA
28,044,9534,4697,4837,28044000000,COLMENAREJO
28,045,55198,27226,27972,28045000000,COLMENAR VIEJO
28,046,7490,3722,3768,28046000000,COLLADO MEDIANO
28,047,65657,31764,33893,28047000000,COLLADO VILLALBA
28,048,798,399,399,28048000000,CORPA
28,049,80171,39002,41169,28049000000,COSLADA
28,050,6817,3444,3373,28050000000,CUBAS DE LA SAGRA
28,051,2604,1292,1312,28051000000,CHAPINERÍA
28,052,5664,2836,2828,28052000000,CHINCHÓN
28,053,10611,5293,5318,28053000000,DAGANZO DE ARRIBA
28,054,16873,8293,8580,28054000000,EL ESCORIAL (EL)
28,055,1453,749,704,28055000000,ESTREMERA
28,056,1791,905,886,28056000000,FRESNEDILLAS DE LA OLIVA
28,057,2522,1327,1195,28057000000,FRESNO DE TOROTE
28,058,188736,92192,96544,28058000000,FUENLABRADA
28,059,7182,3615,3567,28059000000,FUENTE EL SAZ DE JARAMA
28,060,2270,1131,1139,28060000000,FUENTIDUEÑA DE TAJO
28,061,35273,17119,18154,28061000000,GALAPAGAR
28,062,420,228,192,28062000000,GARGANTA DE LOS MONTES
28,063,388,219,169,28063000000,GARGANTILLA DEL LOZOYA Y PINILLA DE BUITRAGO
28,064,229,127,102,28064000000,GASCONES
28,065,185899,90494,95405,28065000000,GETAFE
28,066,10087,5008,5079,28066000000,GRIÑÓN
28,067,6814,3414,3400,28067000000,GUADALIX DE LA SIERRA
28,068,17063,8396,8667,28068000000,GUADARRAMA
28,069,74,47,27,28069000000,LA HIRUELA (LA)
28,070,234,116,118,28070000000,HORCAJO DE LA SIERRA-AOSLOS
28,071,108,55,53,28071000000,HORCAJUELO DE LA SIERRA
28,072,8973,4515,4458,28072000000,HOYO DE MANZANARES
28,073,19902,9908,9994,28073000000,HUMANES DE MADRID
28,074,190665,91731,98934,28074000000,LEGANÉS
28,075,9108,4568,4540,28075000000,LOECHES
28,076,621,324,297,28076000000,LOZOYA
28,078,72,36,36,28078000000,MADARCOS
28,079,3332035,1555507,1776528,28079000000,MADRID
28,080,72548,34263,38285,28080000000,MAJADAHONDA
28,082,9386,4714,4672,28082000000,MANZANARES EL REAL
28,083,15404,7725,7679,28083000000,MECO
28,084,24274,12035,12239,28084000000,MEJORADA DEL CAMPO
28,085,6945,3544,3401,28085000000,MIRAFLORES DE LA SIERRA
28,086,9759,4944,4815,28086000000,EL MOLAR (EL)
28,087,4786,2383,2403,28087000000,LOS MOLINOS (LOS)
28,088,381,197,184,28088000000,MONTEJO DE LA SIERRA
28,089,5453,2760,2693,28089000000,MORALEJA DE ENMEDIO
28,090,14124,7032,7092,28090000000,MORALZARZAL
28,091,8115,4096,4019,28091000000,MORATA DE TAJUÑA
28,092,211265,102147,109118,28092000000,MÓSTOLES
28,093,3282,1605,1677,28093000000,NAVACERRADA
28,094,1637,831,806,28094000000,NAVALAFUENTE
28,095,2982,1539,1443,28095000000,NAVALAGAMELLA
28,096,31974,15867,16107,28096000000,NAVALCARNERO
28,097,150,95,55,28097000000,NAVARREDONDA Y SAN MAMÉS
28,099,3244,1689,1555,28099000000,NAVAS DEL REY
28,100,7050,3576,3474,28100000000,NUEVO BAZTÁN
28,101,402,207,195,28101000000,OLMEDA DE LAS FUENTES
28,102,1415,737,678,28102000000,ORUSCO DE TAJUÑA
28,104,27000,13486,13514,28104000000,PARACUELLOS DE JARAMA
28,106,133004,65905,67099,28106000000,PARLA
28,107,566,263,303,28107000000,PATONES
28,108,6400,3233,3167,28108000000,PEDREZUELA
28,109,2982,1516,1466,28109000000,PELAYOS DE LA PRESA
28,110,3176,1589,1587,28110000000,PERALES DE TAJUÑA
28,111,977,509,468,28111000000,PEZUELA DE LAS TORRES
28,112,204,108,96,28112000000,PINILLA DEL VALLE
28,113,55208,27202,28006,28113000000,PINTO
28,114,178,92,86,28114000000,PIÑUÉCAR-GANDULLAS
28,115,88784,42429,46355,28115000000,POZUELO DE ALARCÓN
28,116,1254,650,604,28116000000,POZUELO DEL REY
28,117,150,84,66,28117000000,PRÁDENA DEL RINCÓN
28,118,99,57,42,28118000000,PUEBLA DE LA SIERRA
28,119,3863,1909,1954,28119000000,QUIJORNA
28,120,1736,931,805,28120000000,RASCAFRÍA
28,121,304,169,135,28121000000,REDUEÑA
28,122,912,472,440,28122000000,RIBATEJADA
28,123,100275,49599,50676,28123000000,RIVAS-VACIAMADRID
28,124,135,70,65,28124000000,ROBLEDILLO DE LA JARA
28,125,4705,2450,2255,28125000000,ROBLEDO DE CHAVELA
28,126,79,45,34,28126000000,ROBREGORDO
28,127,98086,47284,50802,28127000000,LAS ROZAS DE MADRID (LAS)
28,128,578,338,240,28128000000,ROZAS DE PUERTO REAL
28,129,13650,6631,7019,28129000000,SAN AGUSTÍN DEL GUADALIX
28,130,38974,18928,20046,28130000000,SAN FERNANDO DE HENARES
28,131,18489,8826,9663,28131000000,SAN LORENZO DE EL ESCORIAL
28,132,20304,10304,10000,28132000000,SAN MARTÍN DE LA VEGA
28,133,9003,4474,4529,28133000000,SAN MARTÍN DE VALDEIGLESIAS
28,134,92734,44957,47777,28134000000,SAN SEBASTIÁN DE LOS REYES
28,135,1517,822,695,28135000000,SANTA MARÍA DE LA ALAMEDA
28,136,942,474,468,28136000000,SANTORCAZ
28,137,2772,1416,1356,28137000000,LOS SANTOS DE LA HUMOSA (LOS)
28,138,106,56,50,28138000000,LA SERNA DEL MONTE (LA)
28,140,4625,2268,2357,28140000000,SERRANILLOS DEL VALLE
28,141,9551,4668,4883,28141000000,SEVILLA LA NUEVA
28,143,85,51,34,28143000000,SOMOSIERRA
28,144,9399,4636,4763,28144000000,SOTO DEL REAL
28,145,4355,2110,2245,28145000000,TALAMANCA DE JARAMA
28,146,2742,1379,1363,28146000000,TIELMES
28,147,1362,709,653,28147000000,TITULCIA
28,148,137711,67409,70302,28148000000,TORREJÓN DE ARDOZ
28,149,10222,5063,5159,28149000000,TORREJÓN DE LA CALZADA
28,150,4756,2352,2404,28150000000,TORREJÓN DE VELASCO
28,151,4949,2468,2481,28151000000,TORRELAGUNA
28,152,25115,12130,12985,28152000000,TORRELODONES
28,153,1144,584,560,28153000000,TORREMOCHA DE JARAMA
28,154,7737,3977,3760,28154000000,TORRES DE LA ALAMEDA
28,155,633,328,305,28155000000,VALDARACETE
28,156,1782,912,870,28156000000,VALDEAVERO
28,157,1045,529,516,28157000000,VALDELAGUNA
28,158,1066,550,516,28158000000,VALDEMANCO
28,159,820,419,401,28159000000,VALDEMAQUEDA
28,160,13651,6845,6806,28160000000,VALDEMORILLO
28,161,81394,40018,41376,28161000000,VALDEMORO
28,162,4523,2313,2210,28162000000,VALDEOLMOS-ALALPARDO
28,163,623,325,298,28163000000,VALDEPIÉLAGOS
28,164,4990,2482,2508,28164000000,VALDETORRES DE JARAMA
28,165,3191,1642,1549,28165000000,VALDILECHA
28,166,535,283,252,28166000000,VALVERDE DE ALCALÁ
28,167,13376,6686,6690,28167000000,VELILLA DE SAN ANTONIO
28,168,2200,1140,1060,28168000000,EL VELLÓN (EL)
28,169,2554,1327,1227,28169000000,VENTURADA
28,170,3499,1794,1705,28170000000,VILLACONEJOS
28,171,7273,3697,3576,28171000000,VILLA DEL PRADO
28,172,16823,8495,8328,28172000000,VILLALBILLA
28,173,800,418,382,28173000000,VILLAMANRIQUE DE TAJO
28,174,2774,1410,1364,28174000000,VILLAMANTA
28,175,1576,783,793,28175000000,VILLAMANTILLA
28,176,23593,11458,12135,28176000000,VILLANUEVA DE LA CAÑADA
28,177,17731,8580,9151,28177000000,VILLANUEVA DEL PARDILLO
28,178,1671,861,810,28178000000,VILLANUEVA DE PERALES
28,179,2258,1132,1126,28179000000,VILLAR DEL OLMO
28,180,7746,3834,3912,28180000000,VILLAREJO DE SALVANÉS
28,181,28750,13889,14861,28181000000,VILLAVICIOSA DE ODÓN
28,182,314,166,148,28182000000,VILLAVIEJA DEL LOZOYA
28,183,1810,931,879,28183000000,ZARZALEJO
28,901,1483,769,714,28901000000,LOZOYUELA-NAVAS-SIETEIGLESIAS
28,902,760,401,359,28902000000,PUENTES VIEJAS
28,903,51453,24924,26529,28903000000,TRES CANTOS
29,001,5434,2743,2691,29001000000,ALAMEDA
29,002,2554,1301,1253,29002000000,ALCAUCÍN
29,003,1059,552,507,29003000000,ALFARNATE
29,004,380,196,184,29004000000,ALFARNATEJO
29,005,6773,3375,3398,29005000000,ALGARROBO
29,006,829,442,387,29006000000,ALGATOCÍN
29,007,43674,21662,22012,29007000000,ALHAURÍN DE LA TORRE
29,008,26879,13381,13498,29008000000,ALHAURÍN EL GRANDE
29,009,1848,949,899,29009000000,ALMÁCHAR
29,010,1924,974,950,29010000000,ALMARGEN
29,011,3967,2065,1902,29011000000,ALMOGÍA
29,012,13512,6812,6700,29012000000,ÁLORA
29,013,2065,1041,1024,29013000000,ALOZAINA
29,014,281,139,142,29014000000,ALPANDEIRE
29,015,41178,20208,20970,29015000000,ANTEQUERA
29,016,391,197,194,29016000000,ÁRCHEZ
29,017,8050,4075,3975,29017000000,ARCHIDONA
29,018,2522,1275,1247,29018000000,ARDALES
29,019,1264,650,614,29019000000,ARENAS
29,020,4068,2010,2058,29020000000,ARRIATE
29,021,185,98,87,29021000000,ATAJATE
29,022,230,112,118,29022000000,BENADALID
29,023,9244,4612,4632,29023000000,BENAHAVÍS
29,024,460,240,220,29024000000,BENALAURÍA
29,025,75801,37050,38751,29025000000,BENALMÁDENA
29,026,1557,802,755,29026000000,BENAMARGOSA
29,027,3079,1549,1530,29027000000,BENAMOCARRA
29,028,1437,735,702,29028000000,BENAOJÁN
29,029,454,237,217,29029000000,BENARRABÁ
29,030,925,472,453,29030000000,EL BORGE (EL)
29,031,1780,906,874,29031000000,EL BURGO (EL)
29,032,8435,4226,4209,29032000000,CAMPILLOS
29,033,1767,920,847,29033000000,CANILLAS DE ACEITUNO
29,034,801,393,408,29034000000,CANILLAS DE ALBAIDA
29,035,1598,786,812,29035000000,CAÑETE LA REAL
29,036,750,391,359,29036000000,CARRATRACA
29,037,232,121,111,29037000000,CARTAJIMA
29,038,28412,14352,14060,29038000000,CÁRTAMA
29,039,3910,2037,1873,29039000000,CASABERMEJA
29,040,2522,1351,1171,29040000000,CASARABONELA
29,041,8111,4166,3945,29041000000,CASARES
29,042,25023,12542,12481,29042000000,COÍN
29,043,3494,1793,1701,29043000000,COLMENAR
29,044,1339,715,624,29044000000,COMARES
29,045,3875,1939,1936,29045000000,CÓMPETA
29,046,3014,1566,1448,29046000000,CORTES DE LA FRONTERA
29,047,1337,649,688,29047000000,CUEVAS BAJAS
29,048,1592,783,809,29048000000,CUEVAS DEL BECERRO
29,049,3647,1830,1817,29049000000,CUEVAS DE SAN MARCOS
29,050,592,304,288,29050000000,CÚTAR
29,051,76975,37624,39351,29051000000,ESTEPONA
29,052,280,138,142,29052000000,FARAJÁN
29,053,3322,1662,1660,29053000000,FRIGILIANA
29,054,85598,41521,44077,29054000000,FUENGIROLA
29,055,2891,1431,1460,29055000000,FUENTE DE PIEDRA
29,056,1591,823,768,29056000000,GAUCÍN
29,057,410,204,206,29057000000,GENALGUACIL
29,058,2307,1186,1121,29058000000,GUARO
29,059,3331,1660,1671,29059000000,HUMILLADERO
29,060,774,389,385,29060000000,IGUALEJA
29,061,1621,804,817,29061000000,ISTÁN
29,062,915,471,444,29062000000,IZNATE
29,063,400,210,190,29063000000,JIMERA DE LÍBAR
29,064,561,286,275,29064000000,JUBRIQUE
29,065,243,137,106,29065000000,JÚZCAR
29,066,523,289,234,29066000000,MACHARAVIAYA
29,067,586384,281265,305119,29067000000,MÁLAGA
29,068,17857,8979,8878,29068000000,MANILVA
29,069,156295,74623,81672,29069000000,MARBELLA
29,070,91691,45335,46356,29070000000,MIJAS
29,071,1220,625,595,29071000000,MOCLINEJO
29,072,5413,2691,2722,29072000000,MOLLINA
29,073,2937,1529,1408,29073000000,MONDA
29,074,970,487,483,29074000000,MONTEJAQUE
29,075,21913,10751,11162,29075000000,NERJA
29,076,4480,2296,2184,29076000000,OJÉN
29,077,280,145,135,29077000000,PARAUTA
29,079,3290,1702,1588,29079000000,PERIANA
29,080,9886,4960,4926,29080000000,PIZARRA
29,081,279,139,140,29081000000,PUJERRA
29,082,51300,25044,26256,29082000000,RINCÓN DE LA VICTORIA
29,083,2795,1462,1333,29083000000,RIOGORDO
29,084,33329,16130,17199,29084000000,RONDA
29,085,187,101,86,29085000000,SALARES
29,086,1647,865,782,29086000000,SAYALONGA
29,087,611,342,269,29087000000,SEDELLA
29,088,3418,1707,1711,29088000000,SIERRA DE YEGUAS
29,089,3678,1842,1836,29089000000,TEBA
29,090,2347,1200,1147,29090000000,TOLOX
29,091,20932,10536,10396,29091000000,TORROX
29,092,767,389,378,29092000000,TOTALÁN
29,093,2441,1232,1209,29093000000,VALLE DE ABDALAJÍS
29,094,85377,42009,43368,29094000000,VÉLEZ-MÁLAGA
29,095,4113,2079,2034,29095000000,VILLANUEVA DE ALGAIDAS
29,096,3348,1638,1710,29096000000,VILLANUEVA DEL ROSARIO
29,097,5360,2677,2683,29097000000,VILLANUEVA DEL TRABUCO
29,098,1405,711,694,29098000000,VILLANUEVA DE TAPIA
29,099,2059,1071,988,29099000000,VIÑUELA
29,100,2823,1437,1386,29100000000,YUNQUERA
29,901,70434,35209,35225,29901000000,TORREMOLINOS
29,902,3302,1594,1708,29902000000,VILLANUEVA DE LA CONCEPCIÓN
29,903,588,314,274,29903000000,MONTECORTO
29,904,447,224,223,29904000000,SERRATO
30,001,6216,3163,3053,30001000000,ABANILLA
30,002,12964,6473,6491,30002000000,ABARÁN
30,003,36862,18364,18498,30003000000,ÁGUILAS
30,004,1390,705,685,30004000000,ALBUDEITE
30,005,43049,21315,21734,30005000000,ALCANTARILLA
30,006,1123,554,569,30006000000,ALEDO
30,007,10218,5277,4941,30007000000,ALGUAZAS
30,008,23280,11769,11511,30008000000,ALHAMA DE MURCIA
30,009,20110,10546,9564,30009000000,ARCHENA
30,010,11501,5978,5523,30010000000,BENIEL
30,011,6756,3481,3275,30011000000,BLANCA
30,012,11664,5864,5800,30012000000,BULLAS
30,013,10161,5150,5011,30013000000,CALASPARRA
30,014,2143,1017,1126,30014000000,CAMPOS DEL RÍO
30,015,25756,12850,12906,30015000000,CARAVACA DE LA CRUZ
30,016,218050,108296,109754,30016000000,CARTAGENA
30,017,14485,7236,7249,30017000000,CEHEGÍN
30,018,12668,6393,6275,30018000000,CEUTÍ
30,019,35286,17672,17614,30019000000,CIEZA
30,020,11094,5863,5231,30020000000,FORTUNA
30,021,18063,9429,8634,30021000000,FUENTE ÁLAMO DE MURCIA
30,022,26784,14030,12754,30022000000,JUMILLA
30,023,5729,2928,2801,30023000000,LIBRILLA
30,024,98447,50526,47921,30024000000,LORCA
30,025,7706,3924,3782,30025000000,LORQUÍ
30,026,34462,17918,16544,30026000000,MAZARRÓN
30,027,76074,37879,38195,30027000000,MOLINA DE SEGURA
30,028,7588,3841,3747,30028000000,MORATALLA
30,029,17382,8843,8539,30029000000,MULA
30,030,469177,230043,239134,30030000000,MURCIA
30,031,539,283,256,30031000000,OJÓS
30,032,3937,2039,1898,30032000000,PLIEGO
30,033,17346,9023,8323,30033000000,PUERTO LUMBRERAS
30,034,1240,662,578,30034000000,RICOTE
30,035,35241,17672,17569,30035000000,SAN JAVIER
30,036,27691,13836,13855,30036000000,SAN PEDRO DEL PINATAR
30,037,39037,20157,18880,30037000000,TORRE-PACHECO
30,038,22183,11218,10965,30038000000,LAS TORRES DE COTILLAS (LAS)
30,039,33149,17032,16117,30039000000,TOTANA
30,040,874,454,420,30040000000,ULEA
30,041,20897,10569,10328,30041000000,LA UNIÓN (LA)
30,042,3771,1963,1808,30042000000,VILLANUEVA DEL RÍO SEGURA
30,043,35521,17863,17658,30043000000,YECLA
30,901,16245,8087,8158,30901000000,SANTOMERA
30,902,18598,9483,9115,30902000000,LOS ALCÁZARES (LOS)
31,001,82,47,35,31001000000,ABÁIGAR
31,002,514,253,261,31002000000,ABÁRZUZA/ABARTZUZA
31,003,115,70,45,31003000000,ABAURREGAINA/ABAURREA ALTA
31,004,29,18,11,31004000000,ABAURREPEA/ABAURREA BAJA
31,005,368,197,171,31005000000,ABERIN
31,006,2610,1319,1291,31006000000,ABLITAS
31,007,172,97,75,31007000000,ADIÓS
31,008,76,43,33,31008000000,AGUILAR DE CODÉS
31,009,769,410,359,31009000000,AIBAR/OIBAR
31,010,7590,3816,3774,31010000000,ALTSASU/ALSASUA
31,011,908,493,415,31011000000,ALLÍN/ALLIN
31,012,988,506,482,31012000000,ALLO
31,013,724,397,327,31013000000,AMÉSCOA BAJA
31,014,343,185,158,31014000000,ANCÍN/ANTZIN
31,015,2882,1453,1429,31015000000,ANDOSILLA
31,016,10608,5165,5443,31016000000,ANSOÁIN/ANTSOAIN
31,017,491,263,228,31017000000,ANUE
31,018,628,341,287,31018000000,AÑORBE
31,019,2970,1489,1481,31019000000,AOIZ/AGOITZ
31,020,525,286,239,31020000000,ARAITZ
31,021,70,41,29,31021000000,ARANARACHE/ARANARATXE
31,022,609,323,286,31022000000,ARANTZA
31,023,12517,6276,6241,31023000000,ARANGUREN
31,024,110,62,48,31024000000,ARANO
31,025,987,528,459,31025000000,ARAKIL
31,026,148,78,70,31026000000,ARAS
31,027,1126,590,536,31027000000,ARBIZU
31,028,296,164,132,31028000000,ARCE/ARTZI
31,029,1151,570,581,31029000000,LOS ARCOS (LOS)
31,030,159,89,70,31030000000,ARELLANO
31,031,267,138,129,31031000000,ARESO
31,032,2313,1176,1137,31032000000,ARGUEDAS
31,033,49,32,17,31033000000,ARIA
31,034,34,19,15,31034000000,ARIBE
31,035,54,27,27,31035000000,ARMAÑANZAS
31,036,1035,552,483,31036000000,ARRÓNIZ
31,037,119,66,53,31037000000,ARRUAZU
31,038,1772,912,860,31038000000,ARTAJONA
31,039,116,57,59,31039000000,ARTAZU
31,040,214,121,93,31040000000,ATEZ/ATETZ
31,041,2531,1321,1210,31041000000,AYEGUI/AIEGI
31,042,3749,1887,1862,31042000000,AZAGRA
31,043,37,12,25,31043000000,AZUELO
31,044,343,181,162,31044000000,BAKAIKU
31,045,602,313,289,31045000000,BARÁSOAIN
31,046,46,26,20,31046000000,BARBARIN
31,047,257,125,132,31047000000,BARGOTA
31,048,259,139,120,31048000000,BARILLAS
31,049,845,479,366,31049000000,BASABURUA
31,050,7831,3959,3872,31050000000,BAZTAN
31,051,301,148,153,31051000000,BEIRE
31,052,138,67,71,31052000000,BELASCOÁIN
31,053,672,345,327,31053000000,BERBINZANA
31,054,635,313,322,31054000000,BERTIZARANA
31,055,373,191,182,31055000000,BETELU
31,056,246,131,115,31056000000,BIURRUN-OLCOZ
31,057,2309,1136,1173,31057000000,BUÑUEL
31,058,233,127,106,31058000000,AURITZ/BURGUETE
31,059,195,114,81,31059000000,BURGUI/BURGI
31,060,20865,10038,10827,31060000000,BURLADA/BURLATA
31,061,52,26,26,31061000000,EL BUSTO (EL)
31,062,1379,712,667,31062000000,CABANILLAS
31,063,75,42,33,31063000000,CABREDO
31,064,2186,1154,1032,31064000000,CADREITA
31,065,2786,1452,1334,31065000000,CAPARROSO
31,066,1150,588,562,31066000000,CÁRCAR
31,067,2435,1222,1213,31067000000,CARCASTILLO
31,068,4050,2016,2034,31068000000,CASCANTE
31,069,969,506,463,31069000000,CÁSEDA
31,070,4435,2226,2209,31070000000,CASTEJÓN
31,071,15,10,5,31071000000,CASTILLONUEVO
31,072,8265,4293,3972,31072000000,CINTRUÉNIGO
31,073,352,187,165,31073000000,ZIORDIA
31,074,467,247,220,31074000000,CIRAUQUI/ZIRAUKI
31,075,158,79,79,31075000000,CIRIZA/ZIRITZA
31,076,3891,1996,1895,31076000000,CIZUR
31,077,8629,4351,4278,31077000000,CORELLA
31,078,3149,1609,1540,31078000000,CORTES
31,079,72,37,35,31079000000,DESOJO
31,080,574,303,271,31080000000,DICASTILLO
31,081,455,228,227,31081000000,DONAMARIA
31,082,833,441,392,31082000000,ETXALAR
31,083,75,38,37,31083000000,ECHARRI/ETXARRI
31,084,2521,1303,1218,31084000000,ETXARRI ARANATZ
31,085,653,334,319,31085000000,ETXAURI
31,086,22121,11037,11084,31086000000,VALLE DE EGÜÉS/EGUESIBAR
31,087,205,102,103,31087000000,ELGORRIAGA
31,088,8429,4233,4196,31088000000,NOÁIN (VALLE DE ELORZ)/NOAIN (ELORTZIBAR)
31,089,301,152,149,31089000000,ENÉRIZ/ENERITZ
31,090,155,93,62,31090000000,ERATSUN
31,091,380,204,176,31091000000,ERGOIENA
31,092,812,453,359,31092000000,ERRO
31,093,299,170,129,31093000000,EZCÁROZ/EZKAROZE
31,094,103,50,53,31094000000,ESLAVA
31,095,74,37,37,31095000000,ESPARZA DE SALAZAR/ESPARTZA ZARAITZU
31,096,108,56,52,31096000000,ESPRONCEDA
31,097,14195,6907,7288,31097000000,ESTELLA-LIZARRA
31,098,2832,1454,1378,31098000000,ESTERIBAR
31,099,68,38,30,31099000000,ETAYO
31,100,276,152,124,31100000000,EULATE
31,101,1837,960,877,31101000000,EZCABARTE
31,102,142,97,45,31102000000,EZKURRA
31,103,53,25,28,31103000000,EZPROGUI
31,104,2375,1220,1155,31104000000,FALCES
31,105,2146,1086,1060,31105000000,FITERO
31,106,1005,516,489,31106000000,FONTELLAS
31,107,2543,1358,1185,31107000000,FUNES
31,108,2457,1224,1233,31108000000,FUSTIÑANA
31,109,2353,1211,1142,31109000000,GALAR
31,110,96,53,43,31110000000,GALLIPIENZO/GALIPENTZU
31,111,93,62,31,31111000000,GALLUÉS/GALOZE
31,112,84,50,34,31112000000,GARAIOA
31,113,139,77,62,31113000000,GARDE
31,114,523,278,245,31114000000,GARÍNOAIN
31,115,186,94,92,31115000000,GARRALDA
31,116,67,41,26,31116000000,GENEVILLA
31,117,708,373,335,31117000000,GOIZUETA
31,118,172,102,70,31118000000,GOÑI
31,119,37,22,15,31119000000,GÜESA/GORZA
31,120,431,243,188,31120000000,GUESÁLAZ/GESALATZ
31,121,71,37,34,31121000000,GUIRGUILLANO
31,122,7562,3780,3782,31122000000,HUARTE/UHARTE
31,123,806,417,389,31123000000,UHARTE ARAKIL
31,124,282,158,124,31124000000,IBARGOITI
31,125,301,152,149,31125000000,IGÚZQUIZA
31,126,421,233,188,31126000000,IMOTZ
31,127,165,90,75,31127000000,IRAÑETA
31,128,404,197,207,31128000000,ISABA/IZABA
31,129,532,262,270,31129000000,ITUREN
31,130,418,215,203,31130000000,ITURMENDI
31,131,1330,717,613,31131000000,IZA/ITZA
31,132,159,108,51,31132000000,IZAGAONDOA
31,133,38,22,16,31133000000,IZALZU/ITZALTZU
31,134,176,104,72,31134000000,JAURRIETA
31,135,122,30,92,31135000000,JAVIER
31,136,564,308,256,31136000000,JUSLAPEÑA/TXULAPAIN
31,137,218,128,90,31137000000,BEINTZA-LABAIEN
31,138,1297,679,618,31138000000,LAKUNTZA
31,139,156,89,67,31139000000,LANA
31,140,150,86,64,31140000000,LANTZ
31,141,120,69,51,31141000000,LAPOBLACIÓN
31,142,2087,1092,995,31142000000,LARRAGA
31,143,100,49,51,31143000000,LARRAONA
31,144,910,494,416,31144000000,LARRAUN
31,145,182,94,88,31145000000,LAZAGURRÍA
31,146,37,21,16,31146000000,LEACHE/LEATXE
31,147,135,74,61,31147000000,LEGARDA
31,148,108,52,56,31148000000,LEGARIA
31,149,3016,1550,1466,31149000000,LEITZA
31,150,211,135,76,31150000000,LEOZ/LEOTZ
31,151,49,27,22,31151000000,LERGA
31,152,1798,940,858,31152000000,LERÍN
31,153,2731,1380,1351,31153000000,LESAKA
31,154,244,142,102,31154000000,LEZAUN
31,155,323,169,154,31155000000,LIÉDENA
31,156,303,179,124,31156000000,LIZOAIN-ARRIASGOITI/LIZOAINIBAR-ARRIASGOITI
31,157,4894,2491,2403,31157000000,LODOSA
31,158,309,167,142,31158000000,LÓNGUIDA/LONGIDA
31,159,1326,708,618,31159000000,LUMBIER
31,160,129,68,61,31160000000,LUQUIN
31,161,445,233,212,31161000000,MAÑERU
31,162,52,30,22,31162000000,MARAÑÓN
31,163,2875,1438,1437,31163000000,MARCILLA
31,164,715,368,347,31164000000,MÉLIDA
31,165,3496,1753,1743,31165000000,MENDAVIA
31,166,289,144,145,31166000000,MENDAZA
31,167,1191,621,570,31167000000,MENDIGORRIA
31,168,271,152,119,31168000000,METAUTEN
31,169,3549,1804,1745,31169000000,MILAGRO
31,170,58,29,29,31170000000,MIRAFUENTES
31,171,917,490,427,31171000000,MIRANDA DE ARGA
31,172,503,278,225,31172000000,MONREAL/ELO
31,173,1102,578,524,31173000000,MONTEAGUDO
31,174,116,54,62,31174000000,MORENTIN
31,175,79,45,34,31175000000,MUES
31,176,4237,2138,2099,31176000000,MURCHANTE
31,177,346,177,169,31177000000,MURIETA
31,178,685,361,324,31178000000,MURILLO EL CUENDE
31,179,674,362,312,31179000000,MURILLO EL FRUTO
31,180,269,126,143,31180000000,MURUZÁBAL
31,181,121,70,51,31181000000,NAVASCUÉS/NABASKOZE
31,182,46,25,21,31182000000,NAZAR
31,183,920,454,466,31183000000,OBANOS
31,184,68,38,30,31184000000,OCO
31,185,490,266,224,31185000000,OCHAGAVÍA/OTSAGABIA
31,186,373,203,170,31186000000,ODIETA
31,187,133,72,61,31187000000,OIZ
31,188,409,230,179,31188000000,OLAIBAR
31,189,1483,752,731,31189000000,OLAZTI/OLAZAGUTÍA
31,190,49,27,22,31190000000,OLEJUA
31,191,4019,2022,1997,31191000000,OLITE/ERRIBERRI
31,192,221,126,95,31192000000,OLÓRIZ/OLORITZ
31,193,1836,919,917,31193000000,CENDEA DE OLZA/OLTZA ZENDEA
31,194,435,237,198,31194000000,VALLE DE OLLO/OLLARAN
31,195,191,91,100,31195000000,ORBAIZETA
31,196,29,15,14,31196000000,ORBARA
31,197,74,44,30,31197000000,ORÍSOAIN
31,198,47,25,22,31198000000,ORONZ/ORONTZE
31,199,145,87,58,31199000000,OROZ-BETELU/OROTZ-BETELU
31,200,923,490,433,31200000000,OTEIZA
31,201,205762,97080,108682,31201000000,PAMPLONA/IRUÑA
31,202,5979,3038,2941,31202000000,PERALTA/AZKOIEN
31,203,28,16,12,31203000000,PETILLA DE ARAGÓN
31,204,41,26,15,31204000000,PIEDRAMILLERA
31,205,530,256,274,31205000000,PITILLAS
31,206,2944,1490,1454,31206000000,PUENTE LA REINA/GARES
31,207,346,189,157,31207000000,PUEYO/PUIU
31,208,3715,1918,1797,31208000000,RIBAFORADA
31,209,188,102,86,31209000000,ROMANZADO/ERROMANTZATUA
31,210,209,107,102,31210000000,RONCAL/ERRONKARI
31,211,19,10,9,31211000000,ORREAGA/RONCESVALLES
31,212,130,78,52,31212000000,SADA
31,213,124,69,55,31213000000,SALDÍAS
31,214,109,59,50,31214000000,SALINAS DE ORO/JAITZ
31,215,6429,3210,3219,31215000000,SAN ADRIÁN
31,216,4814,2442,2372,31216000000,SANGÜESA/ZANGOZA
31,217,377,198,179,31217000000,SAN MARTÍN DE UNX
31,219,87,42,45,31219000000,SANSOL
31,220,863,445,418,31220000000,SANTACARA
31,221,1858,913,945,31221000000,DONEZTEBE/SANTESTEBAN
31,222,62,43,19,31222000000,SARRIÉS/SARTZE
31,223,1328,683,645,31223000000,SARTAGUDA
31,224,1226,638,588,31224000000,SESMA
31,225,48,29,19,31225000000,SORLADA
31,226,672,344,328,31226000000,SUNBILLA
31,227,10698,5316,5382,31227000000,TAFALLA
31,228,660,356,304,31228000000,TIEBAS-MURUARTE DE RETA
31,229,54,29,25,31229000000,TIRAPU
31,230,98,52,46,31230000000,TORRALBA DEL RÍO
31,231,117,62,55,31231000000,TORRES DEL RÍO
31,232,37791,18628,19163,31232000000,TUDELA
31,233,148,66,82,31233000000,TULEBRAS
31,234,190,111,79,31234000000,UCAR
31,235,171,94,77,31235000000,UJUÉ/UXUE
31,236,1636,843,793,31236000000,ULTZAMA
31,237,225,133,92,31237000000,UNCITI
31,238,158,83,75,31238000000,UNZUÉ/UNTZUE
31,239,362,183,179,31239000000,URDAZUBI/URDAX
31,240,638,333,305,31240000000,URDIAIN
31,241,135,88,47,31241000000,URRAUL ALTO
31,242,326,149,177,31242000000,URRAUL BAJO
31,243,418,219,199,31243000000,URROZ-VILLA
31,244,177,98,79,31244000000,URROZ
31,245,79,46,33,31245000000,URZAINQUI/URZAINKI
31,246,169,94,75,31246000000,UTERGA
31,247,139,68,71,31247000000,UZTÁRROZ/UZTARROZE
31,248,304,166,138,31248000000,LUZAIDE/VALCARLOS
31,249,2424,1222,1202,31249000000,VALTIERRA
31,250,3792,1865,1927,31250000000,BERA
31,251,4370,2228,2142,31251000000,VIANA
31,252,75,44,31,31252000000,VIDÁNGOZ/BIDANKOZE
31,253,165,85,80,31253000000,BIDAURRETA
31,254,3004,1549,1455,31254000000,VILLAFRANCA
31,255,117,59,58,31255000000,VILLAMAYOR DE MONJARDÍN
31,256,101,57,44,31256000000,HIRIBERRI/VILLANUEVA DE AEZKOA
31,257,1266,627,639,31257000000,VILLATUERTA
31,258,10067,4891,5176,31258000000,VILLAVA/ATARRABIA
31,259,572,305,267,31259000000,IGANTZI
31,260,1581,820,761,31260000000,VALLE DE YERRI/DEIERRI
31,261,294,171,123,31261000000,YESA
31,262,289,155,134,31262000000,ZABALZA/ZABALTZA
31,263,292,149,143,31263000000,ZUBIETA
31,264,231,112,119,31264000000,ZUGARRAMURDI
31,265,89,52,37,31265000000,ZÚÑIGA
31,901,19575,9424,10151,31901000000,BARAÑÁIN/BARAÑAIN
31,902,7541,3832,3709,31902000000,BERRIOPLANO/BERRIOBEITI
31,903,10919,5484,5435,31903000000,BERRIOZAR
31,904,2316,1200,1116,31904000000,IRURTZUN
31,905,4129,2039,2090,31905000000,BERIÁIN
31,906,4051,2054,1997,31906000000,ORKOIEN
31,907,15715,7715,8000,31907000000,ZIZUR MAYOR/ZIZUR NAGUSIA
31,908,1689,867,822,31908000000,LEKUNBERRI
32,001,6378,3177,3201,32001000000,ALLARIZ
32,002,2391,1203,1188,32002000000,AMOEIRO
32,003,1002,489,513,32003000000,A ARNOIA (A)
32,004,1754,799,955,32004000000,AVIÓN
32,005,884,475,409,32005000000,BALTAR
32,006,1482,746,736,32006000000,BANDE
32,007,1535,762,773,32007000000,BAÑOS DE MOLGAS
32,008,11140,5385,5755,32008000000,BARBADÁS
32,009,13277,6424,6853,32009000000,O BARCO DE VALDEORRAS (O)
32,010,364,188,176,32010000000,BEADE
32,011,946,431,515,32011000000,BEARIZ
32,012,716,393,323,32012000000,OS BLANCOS (OS)
32,013,2232,1066,1166,32013000000,BOBORÁS
32,014,1069,512,557,32014000000,A BOLA (A)
32,015,806,408,398,32015000000,O BOLO (O)
32,016,679,344,335,32016000000,CALVOS DE RANDÍN
32,017,1373,697,676,32017000000,CARBALLEDA DE VALDEORRAS
32,018,1218,599,619,32018000000,CARBALLEDA DE AVIA
32,019,13968,6501,7467,32019000000,O CARBALLIÑO (O)
32,020,2521,1246,1275,32020000000,CARTELLE
32,021,989,511,478,32021000000,CASTRELO DO VAL
32,022,1337,670,667,32022000000,CASTRELO DE MIÑO
32,023,1222,635,587,32023000000,CASTRO CALDELAS
32,024,5709,2680,3029,32024000000,CELANOVA
32,025,1087,536,551,32025000000,CENLLE
32,026,3176,1588,1588,32026000000,COLES
32,027,1032,507,525,32027000000,CORTEGADA
32,028,1606,843,763,32028000000,CUALEDRO
32,029,493,258,235,32029000000,CHANDREXA DE QUEIXA
32,030,1098,521,577,32030000000,ENTRIMO
32,031,1099,554,545,32031000000,ESGOS
32,032,9529,4604,4925,32032000000,XINZO DE LIMIA
32,033,667,340,327,32033000000,GOMESENDE
32,034,1180,602,578,32034000000,A GUDIÑA (A)
32,035,1391,674,717,32035000000,O IRIXO (O)
32,036,1368,691,677,32036000000,XUNQUEIRA DE AMBÍA
32,037,689,345,344,32037000000,XUNQUEIRA DE ESPADANEDO
32,038,444,210,234,32038000000,LAROUCO
32,039,1167,614,553,32039000000,LAZA
32,040,1481,729,752,32040000000,LEIRO
32,041,768,387,381,32041000000,LOBEIRA
32,042,1786,885,901,32042000000,LOBIOS
32,043,2878,1429,1449,32043000000,MACEDA
32,044,832,405,427,32044000000,MANZANEDA
32,045,2743,1363,1380,32045000000,MASIDE
32,046,1123,542,581,32046000000,MELÓN
32,047,1954,984,970,32047000000,A MERCA (A)
32,048,1007,520,487,32048000000,A MEZQUITA (A)
32,049,688,369,319,32049000000,MONTEDERRAMO
32,050,2424,1233,1191,32050000000,MONTERREI
32,051,1439,721,718,32051000000,MUÍÑOS
32,052,2085,1054,1031,32052000000,NOGUEIRA DE RAMUÍN
32,053,1730,942,788,32053000000,OÍMBRA
32,054,104250,47322,56928,32054000000,OURENSE
32,055,1368,687,681,32055000000,PADERNE DE ALLARIZ
32,056,1614,801,813,32056000000,PADRENDA
32,057,520,281,239,32057000000,PARADA DE SIL
32,058,6647,3422,3225,32058000000,O PEREIRO DE AGUIAR (O)
32,059,1779,874,905,32059000000,A PEROXA (A)
32,060,875,442,433,32060000000,PETÍN
32,061,1151,593,558,32061000000,PIÑOR
32,062,841,395,446,32062000000,PORQUEIRA
32,063,1977,967,1010,32063000000,A POBRA DE TRIVES (A)
32,064,468,231,237,32064000000,PONTEDEVA
32,065,751,366,385,32065000000,PUNXÍN
32,066,607,288,319,32066000000,QUINTELA DE LEIRADO
32,067,1220,626,594,32067000000,RAIRIZ DE VEIGA
32,068,1521,723,798,32068000000,RAMIRÁS
32,069,4973,2443,2530,32069000000,RIBADAVIA
32,070,518,264,254,32070000000,SAN XOÁN DE RÍO
32,071,1414,721,693,32071000000,RIÓS
32,072,4141,2076,2065,32072000000,A RÚA (A)
32,073,1384,681,703,32073000000,RUBIÁ
32,074,1049,508,541,32074000000,SAN AMARO
32,075,5675,2866,2809,32075000000,SAN CIBRAO DAS VIÑAS
32,076,2003,994,1009,32076000000,SAN CRISTOVO DE CEA
32,077,1134,539,595,32077000000,SANDIÁS
32,078,1095,537,558,32078000000,SARREAUS
32,079,1487,765,722,32079000000,TABOADELA
32,080,342,180,162,32080000000,A TEIXEIRA (A)
32,081,2378,1219,1159,32081000000,TOÉN
32,082,1228,610,618,32082000000,TRASMIRAS
32,083,925,490,435,32083000000,A VEIGA (A)
32,084,964,473,491,32084000000,VEREA
32,085,13612,6538,7074,32085000000,VERÍN
32,086,2750,1385,1365,32086000000,VIANA DO BOLO
32,087,1866,944,922,32087000000,VILAMARÍN
32,088,1851,937,914,32088000000,VILAMARTÍN DE VALDEORRAS
32,089,1201,604,597,32089000000,VILAR DE BARRIO
32,090,792,393,399,32090000000,VILAR DE SANTOS
32,091,1702,904,798,32091000000,VILARDEVÓS
32,092,521,300,221,32092000000,VILARIÑO DE CONSO
33,001,1552,767,785,33001000000,ALLANDE
33,002,10076,4946,5130,33002000000,ALLER
33,003,599,336,263,33003000000,AMIEVA
33,004,75518,35623,39895,33004000000,AVILÉS
33,005,1399,747,652,33005000000,BELMONTE DE MIRANDA
33,006,1669,820,849,33006000000,BIMENES
33,007,1412,722,690,33007000000,BOAL
33,008,1918,962,956,33008000000,CABRALES
33,009,1105,561,544,33009000000,CABRANES
33,010,1932,944,988,33010000000,CANDAMO
33,011,11596,5640,5956,33011000000,CANGAS DEL NARCEA
33,012,6362,3068,3294,33012000000,CANGAS DE ONÍS
33,013,496,260,236,33013000000,CARAVIA
33,014,10177,4897,5280,33014000000,CARREÑO
33,015,1449,837,612,33015000000,CASO
33,016,22103,10663,11440,33016000000,CASTRILLÓN
33,017,3289,1607,1682,33017000000,CASTROPOL
33,018,3304,1625,1679,33018000000,COAÑA
33,019,3187,1580,1607,33019000000,COLUNGA
33,020,15612,7641,7971,33020000000,CORVERA DE ASTURIAS
33,021,4909,2420,2489,33021000000,CUDILLERO
33,022,805,411,394,33022000000,DEGAÑA
33,023,3749,1827,1922,33023000000,EL FRANCO (EL)
33,024,268313,126085,142228,33024000000,GIJÓN
33,025,10470,5117,5353,33025000000,GOZÓN
33,026,9616,4668,4948,33026000000,GRADO
33,027,765,392,373,33027000000,GRANDAS DE SALIME
33,028,1121,645,476,33028000000,IBIAS
33,029,288,149,139,33029000000,ILLANO
33,030,1061,538,523,33030000000,ILLAS
33,031,37978,18080,19898,33031000000,LANGREO
33,032,12355,5924,6431,33032000000,LAVIANA
33,033,10312,4969,5343,33033000000,LENA
33,034,10958,5397,5561,33034000000,VALDÉS
33,035,13948,6887,7061,33035000000,LLANERA
33,036,13524,6574,6950,33036000000,LLANES
33,037,36195,17187,19008,33037000000,MIERES
33,038,2540,1277,1263,33038000000,MORCÍN
33,039,1955,949,1006,33039000000,MUROS DE NALÓN
33,040,5186,2550,2636,33040000000,NAVA
33,041,8136,3913,4223,33041000000,NAVIA
33,042,5058,2430,2628,33042000000,NOREÑA
33,043,746,401,345,33043000000,ONÍS
33,044,217584,100640,116944,33044000000,OVIEDO
33,045,5208,2554,2654,33045000000,PARRES
33,046,535,281,254,33046000000,PEÑAMELLERA ALTA
33,047,1221,604,617,33047000000,PEÑAMELLERA BAJA
33,048,138,75,63,33048000000,PESOZ
33,049,6822,3329,3493,33049000000,PILOÑA
33,050,579,342,237,33050000000,PONGA
33,051,7830,3823,4007,33051000000,PRAVIA
33,052,709,419,290,33052000000,PROAZA
33,053,1175,682,493,33053000000,QUIRÓS
33,054,1888,960,928,33054000000,LAS REGUERAS (LAS)
33,055,1731,842,889,33055000000,RIBADEDEVA
33,056,5548,2638,2910,33056000000,RIBADESELLA
33,057,1857,931,926,33057000000,RIBERA DE ARRIBA
33,058,1755,891,864,33058000000,RIOSA
33,059,4806,2383,2423,33059000000,SALAS
33,060,15431,7395,8036,33060000000,SAN MARTÍN DEL REY AURELIO
33,061,344,170,174,33061000000,SAN MARTÍN DE OSCOS
33,062,431,223,208,33062000000,SANTA EULALIA DE OSCOS
33,063,412,193,219,33063000000,SAN TIRSO DE ABRES
33,064,286,140,146,33064000000,SANTO ADRIANO
33,065,1271,612,659,33065000000,SARIEGO
33,066,52194,25493,26701,33066000000,SIERO
33,067,851,451,400,33067000000,SOBRESCOBIO
33,068,1083,640,443,33068000000,SOMIEDO
33,069,3818,1869,1949,33069000000,SOTO DEL BARCO
33,070,3652,1773,1879,33070000000,TAPIA DE CASARIEGO
33,071,576,276,300,33071000000,TARAMUNDI
33,072,1565,862,703,33072000000,TEVERGA
33,073,8857,4477,4380,33073000000,TINEO
33,074,3885,1868,2017,33074000000,VEGADEO
33,075,261,132,129,33075000000,VILLANUEVA DE OSCOS
33,076,15000,7421,7579,33076000000,VILLAVICIOSA
33,077,1104,569,535,33077000000,VILLAYÓN
33,078,133,70,63,33078000000,YERNES Y TAMEZA
34,001,42,25,17,34001000000,ABARCA DE CAMPOS
34,003,167,90,77,34003000000,ABIA DE LAS TORRES
34,004,6733,3246,3487,34004000000,AGUILAR DE CAMPOO
34,005,922,467,455,34005000000,ALAR DEL REY
34,006,82,48,34,34006000000,ALBA DE CERRATO
34,009,36,22,14,34009000000,AMAYUELAS DE ARRIBA
34,010,589,298,291,34010000000,AMPUDIA
34,011,422,239,183,34011000000,AMUSCO
34,012,340,189,151,34012000000,ANTIGÜEDAD
34,015,45,27,18,34015000000,ARCONADA
34,017,1036,519,517,34017000000,ASTUDILLO
34,018,210,117,93,34018000000,AUTILLA DEL PINO
34,019,129,67,62,34019000000,AUTILLO DE CAMPOS
34,020,53,35,18,34020000000,AYUELA
34,022,1212,621,591,34022000000,BALTANÁS
34,023,6284,3174,3110,34023000000,VENTA DE BAÑOS
34,024,25,15,10,34024000000,BAQUERÍN DE CAMPOS
34,025,54,25,29,34025000000,BÁRCENA DE CAMPOS
34,027,1182,593,589,34027000000,BARRUELO DE SANTULLÁN
34,028,134,71,63,34028000000,BÁSCONES DE OJEDA
34,029,756,377,379,34029000000,BECERRIL DE CAMPOS
34,031,33,17,16,34031000000,BELMONTE DE CAMPOS
34,032,43,24,19,34032000000,BERZOSILLA
34,033,19,14,5,34033000000,BOADA DE CAMPOS
34,034,117,68,49,34034000000,BOADILLA DEL CAMINO
34,035,99,60,39,34035000000,BOADILLA DE RIOSECO
34,036,254,142,112,34036000000,BRAÑOSERA
34,037,309,173,136,34037000000,BUENAVISTA DE VALDAVIA
34,038,275,154,121,34038000000,BUSTILLO DE LA VEGA
34,039,52,32,20,34039000000,BUSTILLO DEL PÁRAMO DE CARRIÓN
34,041,87,42,45,34041000000,CALAHORRA DE BOEDO
34,042,305,169,136,34042000000,CALZADA DE LOS MOLINOS
34,045,71,41,30,34045000000,CAPILLAS
34,046,59,35,24,34046000000,CARDEÑOSA DE VOLPEJERA
34,047,2005,971,1034,34047000000,CARRIÓN DE LOS CONDES
34,048,57,29,28,34048000000,CASTIL DE VELA
34,049,323,174,149,34049000000,CASTREJÓN DE LA PEÑA
34,050,181,102,79,34050000000,CASTRILLO DE DON JUAN
34,051,99,52,47,34051000000,CASTRILLO DE ONIELO
34,052,174,97,77,34052000000,CASTRILLO DE VILLAVEGA
34,053,202,107,95,34053000000,CASTROMOCHO
34,055,261,145,116,34055000000,CERVATOS DE LA CUEZA
34,056,2265,1111,1154,34056000000,CERVERA DE PISUERGA
34,057,466,238,228,34057000000,CEVICO DE LA TORRE
34,058,178,105,73,34058000000,CEVICO NAVERO
34,059,409,201,208,34059000000,CISNEROS
34,060,133,75,58,34060000000,COBOS DE CERRATO
34,061,106,62,44,34061000000,COLLAZOS DE BOEDO
34,062,141,87,54,34062000000,CONGOSTO DE VALDAVIA
34,063,129,70,59,34063000000,CORDOVILLA LA REAL
34,066,62,36,26,34066000000,CUBILLAS DE CERRATO
34,067,133,79,54,34067000000,DEHESA DE MONTEJO
34,068,53,34,19,34068000000,DEHESA DE ROMANOS
34,069,2597,1315,1282,34069000000,DUEÑAS
34,070,123,72,51,34070000000,ESPINOSA DE CERRATO
34,071,167,89,78,34071000000,ESPINOSA DE VILLAGONZALO
34,072,135,69,66,34072000000,FRECHILLA
34,073,178,86,92,34073000000,FRESNO DEL RÍO
34,074,755,380,375,34074000000,FRÓMISTA
34,076,593,308,285,34076000000,FUENTES DE NAVA
34,077,481,246,235,34077000000,FUENTES DE VALDEPERO
34,079,2690,1392,1298,34079000000,GRIJOTA
34,080,5653,2788,2865,34080000000,GUARDO
34,081,57,34,23,34081000000,GUAZA DE CAMPOS
34,082,74,38,36,34082000000,HÉRMEDES DE CERRATO
34,083,1889,929,960,34083000000,HERRERA DE PISUERGA
34,084,151,84,67,34084000000,HERRERA DE VALDECAÑAS
34,086,110,56,54,34086000000,HONTORIA DE CERRATO
34,087,171,91,80,34087000000,HORNILLOS DE CERRATO
34,088,392,217,175,34088000000,HUSILLOS
34,089,146,84,62,34089000000,ITERO DE LA VEGA
34,091,121,66,55,34091000000,LAGARTOS
34,092,281,150,131,34092000000,LANTADILLA
34,093,93,56,37,34093000000,LA VID DE OJEDA (LA)
34,094,64,33,31,34094000000,LEDIGOS
34,096,41,27,14,34096000000,LOMAS
34,098,1011,533,478,34098000000,MAGAZ DE PISUERGA
34,099,52,34,18,34099000000,MANQUILLOS
34,100,143,83,60,34100000000,MANTINOS
34,101,49,22,27,34101000000,MARCILLA DE CAMPOS
34,102,208,125,83,34102000000,MAZARIEGOS
34,103,86,55,31,34103000000,MAZUECOS DE VALDEGINATE
34,104,262,153,109,34104000000,MELGAR DE YUSO
34,106,96,54,42,34106000000,MENESES DE CAMPOS
34,107,71,42,29,34107000000,MICIECES DE OJEDA
34,108,578,310,268,34108000000,MONZÓN DE CAMPOS
34,109,65,35,30,34109000000,MORATINOS
34,110,75,45,30,34110000000,MUDÁ
34,112,44,25,19,34112000000,NOGAL DE LAS HUERTAS
34,113,36,13,23,34113000000,OLEA DE BOEDO
34,114,179,114,65,34114000000,OLMOS DE OJEDA
34,116,59,32,27,34116000000,OSORNILLO
34,120,76331,35884,40447,34120000000,PALENCIA
34,121,213,121,92,34121000000,PALENZUELA
34,122,105,63,42,34122000000,PÁRAMO DE BOEDO
34,123,1895,961,934,34123000000,PAREDES DE NAVA
34,124,59,37,22,34124000000,PAYO DE OJEDA
34,125,76,42,34,34125000000,PEDRAZA DE CAMPOS
34,126,286,162,124,34126000000,PEDROSA DE LA VEGA
34,127,115,54,61,34127000000,PERALES
34,129,162,98,64,34129000000,PINO DEL RÍO
34,130,196,105,91,34130000000,PIÑA DE CAMPOS
34,131,45,25,20,34131000000,POBLACIÓN DE ARROYO
34,132,126,72,54,34132000000,POBLACIÓN DE CAMPOS
34,133,101,58,43,34133000000,POBLACIÓN DE CERRATO
34,134,44,22,22,34134000000,POLENTINOS
34,135,484,266,218,34135000000,POMAR DE VALDIVIA
34,136,167,94,73,34136000000,POZA DE LA VEGA
34,137,19,14,5,34137000000,POZO DE URAMA
34,139,178,98,80,34139000000,PRÁDANOS DE OJEDA
34,140,84,46,38,34140000000,LA PUEBLA DE VALDAVIA (LA)
34,141,259,140,119,34141000000,QUINTANA DEL PUENTE
34,143,180,100,80,34143000000,QUINTANILLA DE ONSOÑA
34,146,56,35,21,34146000000,REINOSO DE CERRATO
34,147,199,111,88,34147000000,RENEDO DE LA VEGA
34,149,27,15,12,34149000000,REQUENA DE CAMPOS
34,151,147,90,57,34151000000,RESPENDA DE LA PEÑA
34,152,136,65,71,34152000000,REVENGA DE CAMPOS
34,154,78,43,35,34154000000,REVILLA DE COLLAZOS
34,155,153,79,74,34155000000,RIBAS DE CAMPOS
34,156,55,33,22,34156000000,RIBEROS DE LA CUEZA
34,157,2904,1489,1415,34157000000,SALDAÑA
34,158,312,162,150,34158000000,SALINAS DE PISUERGA
34,159,415,242,173,34159000000,SAN CEBRIÁN DE CAMPOS
34,160,146,80,66,34160000000,SAN CEBRIÁN DE MUDÁ
34,161,19,13,6,34161000000,SAN CRISTÓBAL DE BOEDO
34,163,46,24,22,34163000000,SAN MAMÉS DE CAMPOS
34,165,53,32,21,34165000000,SAN ROMÁN DE LA CUBA
34,167,96,53,43,34167000000,SANTA CECILIA DEL ALCOR
34,168,49,29,20,34168000000,SANTA CRUZ DE BOEDO
34,169,402,226,176,34169000000,SANTERVÁS DE LA VEGA
34,170,47,27,20,34170000000,SANTIBÁÑEZ DE ECLA
34,171,962,464,498,34171000000,SANTIBÁÑEZ DE LA PEÑA
34,174,188,104,84,34174000000,SANTOYO
34,175,89,53,36,34175000000,LA SERNA (LA)
34,176,158,91,67,34176000000,SOTOBAÑADO Y PRIORATO
34,177,175,100,75,34177000000,SOTO DE CERRATO
34,178,138,74,64,34178000000,TABANERA DE CERRATO
34,179,23,14,9,34179000000,TABANERA DE VALDAVIA
34,180,75,39,36,34180000000,TÁMARA DE CAMPOS
34,181,483,253,230,34181000000,TARIEGO DE CERRATO
34,182,949,514,435,34182000000,TORQUEMADA
34,184,45,28,17,34184000000,TORREMORMOJÓN
34,185,73,43,30,34185000000,TRIOLLO
34,186,54,28,26,34186000000,VALBUENA DE PISUERGA
34,189,56,33,23,34189000000,VALDEOLMILLOS
34,190,49,26,23,34190000000,VALDERRÁBANO
34,192,82,51,31,34192000000,VALDE-UCIEZA
34,196,82,45,37,34196000000,VALLE DE CERRATO
34,199,1145,582,563,34199000000,VELILLA DEL RÍO CARRIÓN
34,201,163,84,79,34201000000,VERTAVILLO
34,202,33,19,14,34202000000,VILLABASTA DE VALDAVIA
34,204,46,27,19,34204000000,VILLACIDALER
34,205,55,32,23,34205000000,VILLACONANCIO
34,206,850,430,420,34206000000,VILLADA
34,208,49,31,18,34208000000,VILLAELES DE VALDAVIA
34,210,99,59,40,34210000000,VILLAHÁN
34,211,214,113,101,34211000000,VILLAHERREROS
34,213,57,33,24,34213000000,VILLALACO
34,214,202,111,91,34214000000,VILLALBA DE GUARDO
34,215,174,89,85,34215000000,VILLALCÁZAR DE SIRGA
34,216,53,29,24,34216000000,VILLALCÓN
34,217,1871,937,934,34217000000,VILLALOBÓN
34,218,524,302,222,34218000000,VILLALUENGA DE LA VEGA
34,220,175,95,80,34220000000,VILLAMARTÍN DE CAMPOS
34,221,181,110,71,34221000000,VILLAMEDIANA
34,222,111,64,47,34222000000,VILLAMERIEL
34,223,252,152,100,34223000000,VILLAMORONTA
34,224,38,25,13,34224000000,VILLAMUERA DE LA CUEZA
34,225,6459,3315,3144,34225000000,VILLAMURIEL DE CERRATO
34,227,69,37,32,34227000000,VILLANUEVA DEL REBOLLAR
34,228,92,51,41,34228000000,VILLANUÑO DE VALDAVIA
34,229,52,36,16,34229000000,VILLAPROVEDO
34,230,20,13,7,34230000000,VILLARMENTERO DE CAMPOS
34,231,183,95,88,34231000000,VILLARRABÉ
34,232,819,434,385,34232000000,VILLARRAMIEL
34,233,136,81,55,34233000000,VILLASARRACINO
34,234,64,43,21,34234000000,VILLASILA DE VALDAVIA
34,236,138,72,66,34236000000,VILLATURDE
34,237,643,322,321,34237000000,VILLAUMBRALES
34,238,360,174,186,34238000000,VILLAVIUDAS
34,240,73,39,34,34240000000,VILLERÍAS DE CAMPOS
34,241,21,12,9,34241000000,VILLODRE
34,242,107,55,52,34242000000,VILLODRIGO
34,243,336,181,155,34243000000,VILLOLDO
34,245,305,176,129,34245000000,VILLOTA DEL PÁRAMO
34,246,66,36,30,34246000000,VILLOVIECO
34,901,1170,609,561,34901000000,OSORNO LA MAYOR
34,902,170,93,77,34902000000,VALLE DEL RETORTILLO
34,903,184,114,70,34903000000,LOMA DE UCIEZA
34,904,318,185,133,34904000000,LA PERNÍA (LA)
35,001,5568,2802,2766,35001000000,AGAETE
35,002,32643,16422,16221,35002000000,AGÜIMES
35,003,13523,7094,6429,35003000000,ANTIGUA
35,004,64826,32459,32367,35004000000,ARRECIFE
35,005,1032,598,434,35005000000,ARTENARA
35,006,38601,19090,19511,35006000000,ARUCAS
35,007,816,434,382,35007000000,BETANCURIA
35,008,7669,3887,3782,35008000000,FIRGAS
35,009,24678,12360,12318,35009000000,GÁLDAR
35,010,5507,2818,2689,35010000000,HARÍA
35,011,32354,16294,16060,35011000000,INGENIO
35,012,20845,10721,10124,35012000000,MOGÁN
35,013,7889,3991,3898,35013000000,MOYA
35,014,29099,15055,14044,35014000000,LA OLIVA (LA)
35,015,21271,10988,10283,35015000000,PÁJARA
35,016,378027,181846,196181,35016000000,LAS PALMAS DE GRAN CANARIA (LAS)
35,017,43390,21811,21579,35017000000,PUERTO DEL ROSARIO
35,018,19200,9509,9691,35018000000,SAN BARTOLOMÉ
35,019,53912,28282,25630,35019000000,SAN BARTOLOMÉ DE TIRAJANA
35,020,7506,3893,3613,35020000000,LA ALDEA DE SAN NICOLÁS (LA)
35,021,18510,9234,9276,35021000000,SANTA BRÍGIDA
35,022,75677,37587,38090,35022000000,SANTA LUCÍA DE TIRAJANA
35,023,13948,6945,7003,35023000000,SANTA MARÍA DE GUÍA DE GRAN CANARIA
35,024,23881,11962,11919,35024000000,TEGUISE
35,025,1844,1008,836,35025000000,TEJEDA
35,026,102487,50233,52254,35026000000,TELDE
35,027,12799,6547,6252,35027000000,TEROR
35,028,21433,10900,10533,35028000000,TÍAS
35,029,6759,3428,3331,35029000000,TINAJO
35,030,15967,8139,7828,35030000000,TUINEJE
35,031,9667,4860,4807,35031000000,VALSEQUILLO DE GRAN CANARIA
35,032,3733,1950,1783,35032000000,VALLESECO
35,033,7782,3993,3789,35033000000,VEGA DE SAN MATEO
35,034,17415,8932,8483,35034000000,YAIZA
36,001,2647,1367,1280,36001000000,ARBO
36,002,3651,1783,1868,36002000000,BARRO
36,003,12407,6109,6298,36003000000,BAIONA
36,004,11922,5857,6065,36004000000,BUEU
36,005,9620,4659,4961,36005000000,CALDAS DE REIS
36,006,13681,6605,7076,36006000000,CAMBADOS
36,007,1723,822,901,36007000000,CAMPO LAMEIRO
36,008,26807,13288,13519,36008000000,CANGAS
36,009,5090,2489,2601,36009000000,A CAÑIZA (A)
36,010,3289,1593,1696,36010000000,CATOIRA
36,013,2426,1259,1167,36013000000,COVELO
36,014,1978,969,1009,36014000000,CRECENTE
36,015,4549,2161,2388,36015000000,CUNTIS
36,016,1017,526,491,36016000000,DOZÓN
36,017,20081,9665,10416,36017000000,A ESTRADA (A)
36,018,3186,1518,1668,36018000000,FORCAREI
36,019,1647,802,845,36019000000,FORNELOS DE MONTES
36,020,2254,1120,1134,36020000000,AGOLADA
36,021,15043,7502,7541,36021000000,GONDOMAR
36,022,10828,5318,5510,36022000000,O GROVE (O)
36,023,9998,4929,5069,36023000000,A GUARDA (A)
36,024,20282,9904,10378,36024000000,LALÍN
36,025,2520,1267,1253,36025000000,A LAMA (A)
36,026,24197,11970,12227,36026000000,MARÍN
36,027,5258,2569,2689,36027000000,MEAÑO
36,028,4706,2262,2444,36028000000,MEIS
36,029,19315,9387,9928,36029000000,MOAÑA
36,030,4444,2200,2244,36030000000,MONDARIZ
36,031,703,356,347,36031000000,MONDARIZ-BALNEARIO
36,032,4126,2008,2118,36032000000,MORAÑA
36,033,15076,7432,7644,36033000000,MOS
36,034,3739,1841,1898,36034000000,AS NEVES (AS)
36,035,18045,8856,9189,36035000000,NIGRÁN
36,036,3104,1528,1576,36036000000,OIA
36,037,2993,1466,1527,36037000000,PAZOS DE BORBÉN
36,038,82535,38885,43650,36038000000,PONTEVEDRA
36,039,20562,10116,10446,36039000000,O PORRIÑO (O)
36,040,2823,1362,1461,36040000000,PORTAS
36,041,17297,8520,8777,36041000000,POIO
36,042,23154,11208,11946,36042000000,PONTEAREAS
36,043,5553,2657,2896,36043000000,PONTE CALDELAS
36,044,3096,1525,1571,36044000000,PONTECESURES
36,045,28937,13994,14943,36045000000,REDONDELA
36,046,5189,2535,2654,36046000000,RIBADUMIA
36,047,2260,1142,1118,36047000000,RODEIRO
36,048,6431,3157,3274,36048000000,O ROSAL (O)
36,049,9421,4701,4720,36049000000,SALCEDA DE CASELAS
36,050,10274,5107,5167,36050000000,SALVATERRA DE MIÑO
36,051,17854,8827,9027,36051000000,SANXENXO
36,052,8876,4343,4533,36052000000,SILLEDA
36,053,7603,3783,3820,36053000000,SOUTOMAIOR
36,054,13836,6942,6894,36054000000,TOMIÑO
36,055,17327,8404,8923,36055000000,TUI
36,056,5704,2783,2921,36056000000,VALGA
36,057,293652,138310,155342,36057000000,VIGO
36,058,5950,2927,3023,36058000000,VILABOA
36,059,5082,2530,2552,36059000000,VILA DE CRUCES
36,060,37689,18020,19669,36060000000,VILAGARCÍA DE AROUSA
36,061,10225,4969,5256,36061000000,VILANOVA DE AROUSA
36,901,4876,2402,2474,36901000000,A ILLA DE AROUSA (A)
36,902,5687,2773,2914,36902000000,CERDEDO-COTOBADE
37,001,150,79,71,37001000000,ABUSEJO
37,002,126,71,55,37002000000,AGALLAS
37,003,94,52,42,37003000000,AHIGAL DE LOS ACEITEROS
37,004,31,18,13,37004000000,AHIGAL DE VILLARINO
37,005,79,38,41,37005000000,LA ALAMEDA DE GARDÓN (LA)
37,006,108,54,54,37006000000,LA ALAMEDILLA (LA)
37,007,437,229,208,37007000000,ALARAZ
37,008,5058,2547,2511,37008000000,ALBA DE TORMES
37,009,201,110,91,37009000000,ALBA DE YELTES
37,010,1061,515,546,37010000000,LA ALBERCA (LA)
37,011,103,57,46,37011000000,LA ALBERGUERÍA DE ARGAÑÁN (LA)
37,012,140,78,62,37012000000,ALCONADA
37,013,94,52,42,37013000000,ALDEACIPRESTE
37,014,1131,571,560,37014000000,ALDEADÁVILA DE LA RIBERA
37,015,275,150,125,37015000000,ALDEA DEL OBISPO
37,016,668,337,331,37016000000,ALDEALENGUA
37,017,254,136,118,37017000000,ALDEANUEVA DE FIGUEROA
37,018,106,68,38,37018000000,ALDEANUEVA DE LA SIERRA
37,019,146,81,65,37019000000,ALDEARRODRIGO
37,020,514,274,240,37020000000,ALDEARRUBIA
37,021,66,39,27,37021000000,ALDEASECA DE ALBA
37,022,254,131,123,37022000000,ALDEASECA DE LA FRONTERA
37,023,2518,1275,1243,37023000000,ALDEATEJADA
37,024,100,54,46,37024000000,ALDEAVIEJA DE TORMES
37,025,271,145,126,37025000000,ALDEHUELA DE LA BÓVEDA
37,026,191,104,87,37026000000,ALDEHUELA DE YELTES
37,027,299,162,137,37027000000,ALMENARA DE TORMES
37,028,125,68,57,37028000000,ALMENDRA
37,029,187,111,76,37029000000,ANAYA DE ALBA
37,030,89,48,41,37030000000,AÑOVER DE TORMES
37,031,333,190,143,37031000000,ARABAYONA DE MÓGICA
37,032,725,393,332,37032000000,ARAPILES
37,033,100,53,47,37033000000,ARCEDIANO
37,034,93,45,48,37034000000,EL ARCO (EL)
37,035,256,159,97,37035000000,ARMENTEROS
37,036,48,26,22,37036000000,SAN MIGUEL DEL ROBLEDO
37,037,100,53,47,37037000000,LA ATALAYA (LA)
37,038,927,488,439,37038000000,BABILAFUENTE
37,039,280,142,138,37039000000,BAÑOBÁREZ
37,040,395,217,178,37040000000,BARBADILLO
37,041,71,42,29,37041000000,BARBALOS
37,042,48,29,19,37042000000,BARCEO
37,044,418,235,183,37044000000,BARRUECOPARDO
37,045,28,15,13,37045000000,LA BASTIDA (LA)
37,046,12021,5697,6324,37046000000,BÉJAR
37,047,277,136,141,37047000000,BELEÑA
37,049,131,67,64,37049000000,BERMELLAR
37,050,75,40,35,37050000000,BERROCAL DE HUEBRA
37,051,72,41,31,37051000000,BERROCAL DE SALVATIERRA
37,052,273,142,131,37052000000,BOADA
37,054,245,135,110,37054000000,EL BODÓN (EL)
37,055,130,72,58,37055000000,BOGAJO
37,056,47,19,28,37056000000,LA BOUZA (LA)
37,057,199,104,95,37057000000,BÓVEDA DEL RÍO ALMAR
37,058,60,32,28,37058000000,BRINCONES
37,059,116,58,58,37059000000,BUENAMADRE
37,060,373,193,180,37060000000,BUENAVISTA
37,061,238,124,114,37061000000,EL CABACO (EL)
37,062,75,47,28,37062000000,CABEZABELLOSA DE LA CALZADA
37,063,58,40,18,37063000000,LA CABEZA DE BÉJAR (LA)
37,065,248,133,115,37065000000,CABEZA DEL CABALLO
37,067,4224,2110,2114,37067000000,CABRERIZOS
37,068,324,164,160,37068000000,CABRILLAS
37,069,1191,618,573,37069000000,CALVARRASA DE ABAJO
37,070,597,318,279,37070000000,CALVARRASA DE ARRIBA
37,071,88,51,37,37071000000,LA CALZADA DE BÉJAR (LA)
37,072,137,72,65,37072000000,CALZADA DE DON DIEGO
37,073,702,350,352,37073000000,CALZADA DE VALDUNCIEL
37,074,141,87,54,37074000000,CAMPILLO DE AZABA
37,077,263,151,112,37077000000,EL CAMPO DE PEÑARANDA (EL)
37,078,841,433,408,37078000000,CANDELARIO
37,079,75,50,25,37079000000,CANILLAS DE ABAJO
37,080,275,140,135,37080000000,CANTAGALLO
37,081,909,457,452,37081000000,CANTALAPIEDRA
37,082,817,440,377,37082000000,CANTALPINO
37,083,188,98,90,37083000000,CANTARACILLO
37,085,7555,3747,3808,37085000000,CARBAJOSA DE LA SAGRADA
37,086,111,59,52,37086000000,CARPIO DE AZABA
37,087,1415,736,679,37087000000,CARRASCAL DE BARREGAS
37,088,192,107,85,37088000000,CARRASCAL DEL OBISPO
37,089,72,35,37,37089000000,CASAFRANCA
37,090,61,29,32,37090000000,LAS CASAS DEL CONDE (LAS)
37,091,179,87,92,37091000000,CASILLAS DE FLORES
37,092,2989,1533,1456,37092000000,CASTELLANOS DE MORISCOS
37,096,219,131,88,37096000000,CASTILLEJO DE MARTÍN VIEJO
37,097,37,24,13,37097000000,CASTRAZ
37,098,290,147,143,37098000000,CEPEDA
37,099,66,34,32,37099000000,CERECEDA DE LA SIERRA
37,100,73,37,36,37100000000,CEREZAL DE PEÑAHORCADA
37,101,119,64,55,37101000000,CERRALBO
37,102,368,186,182,37102000000,EL CERRO (EL)
37,103,501,268,233,37103000000,CESPEDOSA DE TORMES
37,104,21,12,9,37104000000,CILLEROS DE LA BASTIDA
37,106,242,126,116,37106000000,CIPÉREZ
37,107,11810,5653,6157,37107000000,CIUDAD RODRIGO
37,108,102,51,51,37108000000,COCA DE ALBA
37,109,179,107,72,37109000000,COLMENAR DE MONTEMAYOR
37,110,111,62,49,37110000000,CORDOVILLA
37,112,166,100,66,37112000000,CRISTÓBAL
37,113,396,209,187,37113000000,EL CUBO DE DON SANCHO (EL)
37,114,80,45,35,37114000000,CHAGARCÍA MEDIANERO
37,115,122,66,56,37115000000,DIOS LE GUARDE
37,116,67,35,32,37116000000,DOÑINOS DE LEDESMA
37,117,2288,1206,1082,37117000000,DOÑINOS DE SALAMANCA
37,118,144,83,61,37118000000,ÉJEME
37,119,101,60,41,37119000000,LA ENCINA (LA)
37,120,111,52,59,37120000000,ENCINA DE SAN SILVESTRE
37,121,618,319,299,37121000000,ENCINAS DE ABAJO
37,122,235,117,118,37122000000,ENCINAS DE ARRIBA
37,123,153,85,68,37123000000,ENCINASOLA DE LOS COMENDADORES
37,124,203,117,86,37124000000,ENDRINAL
37,125,233,129,104,37125000000,ESCURIAL DE LA SIERRA
37,126,34,20,14,37126000000,ESPADAÑA
37,127,211,113,98,37127000000,ESPEJA
37,128,240,132,108,37128000000,ESPINO DE LA ORBADA
37,129,251,141,110,37129000000,FLORIDA DE LIÉBANA
37,130,208,114,94,37130000000,FORFOLEDA
37,131,181,102,79,37131000000,FRADES DE LA SIERRA
37,132,310,155,155,37132000000,LA FREGENEDA (LA)
37,133,102,57,45,37133000000,FRESNEDOSO
37,134,191,102,89,37134000000,FRESNO ALHÁNDIGA
37,135,1284,654,630,37135000000,LA FUENTE DE SAN ESTEBAN (LA)
37,136,662,322,340,37136000000,FUENTEGUINALDO
37,137,89,43,46,37137000000,FUENTELIANTE
37,138,253,133,120,37138000000,FUENTERROBLE DE SALVATIERRA
37,139,233,123,110,37139000000,FUENTES DE BÉJAR
37,140,1043,560,483,37140000000,FUENTES DE OÑORO
37,141,146,73,73,37141000000,GAJATES
37,142,665,379,286,37142000000,GALINDO Y PERAHUY
37,143,394,190,204,37143000000,GALINDUSTE
37,144,333,180,153,37144000000,GALISANCHO
37,145,269,135,134,37145000000,GALLEGOS DE ARGAÑÁN
37,146,109,62,47,37146000000,GALLEGOS DE SOLMIRÓN
37,147,200,114,86,37147000000,GARCIBUEY
37,148,418,217,201,37148000000,GARCIHERNÁNDEZ
37,149,57,33,24,37149000000,GARCIRREY
37,150,31,18,13,37150000000,GEJUELO DEL BARRO
37,151,148,79,69,37151000000,GOLPEJAS
37,152,409,217,192,37152000000,GOMECELLO
37,154,133,82,51,37154000000,GUADRAMIRO
37,155,77,42,35,37155000000,GUIJO DE ÁVILA
37,156,5484,2776,2708,37156000000,GUIJUELO
37,157,70,42,28,37157000000,HERGUIJUELA DE CIUDAD RODRIGO
37,158,230,127,103,37158000000,HERGUIJUELA DE LA SIERRA
37,159,66,33,33,37159000000,HERGUIJUELA DEL CAMPO
37,160,600,303,297,37160000000,HINOJOSA DE DUERO
37,161,110,57,53,37161000000,HORCAJO DE MONTEMAYOR
37,162,212,114,98,37162000000,HORCAJO MEDIANERO
37,163,31,19,12,37163000000,LA HOYA (LA)
37,164,278,155,123,37164000000,HUERTA
37,165,26,11,15,37165000000,IRUELOS
37,166,205,107,98,37166000000,ITUERO DE AZABA
37,167,189,97,92,37167000000,JUZBADO
37,168,436,239,197,37168000000,LAGUNILLA
37,169,183,102,81,37169000000,LARRODRIGO
37,170,1539,755,784,37170000000,LEDESMA
37,171,447,231,216,37171000000,LEDRADA
37,172,923,508,415,37172000000,LINARES DE RIOFRÍO
37,173,1517,776,741,37173000000,LUMBRALES
37,174,1003,522,481,37174000000,MACOTERA
37,175,444,226,218,37175000000,MACHACÓN
37,176,140,79,61,37176000000,MADROÑAL
37,177,290,167,123,37177000000,EL MAÍLLO (EL)
37,178,90,47,43,37178000000,MALPARTIDA
37,179,203,105,98,37179000000,MANCERA DE ABAJO
37,180,60,31,29,37180000000,EL MANZANO (EL)
37,181,264,146,118,37181000000,MARTIAGO
37,182,79,51,28,37182000000,MARTINAMOR
37,183,397,200,197,37183000000,MARTÍN DE YELTES
37,184,262,138,124,37184000000,MASUECO
37,185,683,361,322,37185000000,CASTELLANOS DE VILLIQUERA
37,186,104,58,46,37186000000,LA MATA DE LEDESMA (LA)
37,187,628,306,322,37187000000,MATILLA DE LOS CAÑOS DEL RÍO
37,188,159,90,69,37188000000,LA MAYA (LA)
37,189,102,60,42,37189000000,MEMBRIBE DE LA SIERRA
37,190,179,90,89,37190000000,MIEZA
37,191,93,59,34,37191000000,EL MILANO (EL)
37,192,455,250,205,37192000000,MIRANDA DE AZÁN
37,193,392,214,178,37193000000,MIRANDA DEL CASTAÑAR
37,194,253,130,123,37194000000,MOGARRAZ
37,195,47,26,21,37195000000,MOLINILLO
37,196,59,29,30,37196000000,MONFORTE DE LA SIERRA
37,197,89,54,35,37197000000,MONLEÓN
37,198,241,120,121,37198000000,MONLERAS
37,199,133,77,56,37199000000,MONSAGRO
37,200,211,117,94,37200000000,MONTEJO
37,201,266,142,124,37201000000,MONTEMAYOR DEL RÍO
37,202,1315,677,638,37202000000,MONTERRUBIO DE ARMUÑA
37,203,152,87,65,37203000000,MONTERRUBIO DE LA SIERRA
37,204,245,128,117,37204000000,MORASVERDES
37,205,227,120,107,37205000000,MORILLE
37,206,87,47,40,37206000000,MORÍÑIGO
37,207,552,298,254,37207000000,MORISCOS
37,208,74,45,29,37208000000,MORONTA
37,209,514,272,242,37209000000,MOZÁRBEZ
37,211,208,116,92,37211000000,NARROS DE MATALAYEGUA
37,212,132,72,60,37212000000,NAVACARROS
37,213,76,44,32,37213000000,NAVA DE BÉJAR
37,214,122,64,58,37214000000,NAVA DE FRANCIA
37,215,165,96,69,37215000000,NAVA DE SOTROBAL
37,216,305,167,138,37216000000,NAVALES
37,217,60,29,31,37217000000,NAVALMORAL DE BÉJAR
37,218,43,28,15,37218000000,NAVAMORALES
37,219,156,80,76,37219000000,NAVARREDONDA DE LA RINCONADA
37,221,370,200,170,37221000000,NAVASFRÍAS
37,222,80,47,33,37222000000,NEGRILLA DE PALENCIA
37,223,100,56,44,37223000000,OLMEDO DE CAMACES
37,224,181,94,87,37224000000,LA ORBADA (LA)
37,225,109,58,51,37225000000,PAJARES DE LA LAGUNA
37,226,151,82,69,37226000000,PALACIOS DEL ARZOBISPO
37,228,305,163,142,37228000000,PALACIOSRUBIOS
37,229,145,90,55,37229000000,PALENCIA DE NEGRILLA
37,230,259,135,124,37230000000,PARADA DE ARRIBA
37,231,249,136,113,37231000000,PARADA DE RUBIALES
37,232,394,234,160,37232000000,PARADINAS DE SAN JUAN
37,233,54,31,23,37233000000,PASTORES
37,234,325,162,163,37234000000,EL PAYO (EL)
37,235,222,115,107,37235000000,PEDRAZA DE ALBA
37,236,124,73,51,37236000000,PEDROSILLO DE ALBA
37,237,321,190,131,37237000000,PEDROSILLO DE LOS AIRES
37,238,129,67,62,37238000000,PEDROSILLO EL RALO
37,239,209,110,99,37239000000,EL PEDROSO DE LA ARMUÑA (EL)
37,240,1323,719,604,37240000000,PELABRAVO
37,241,162,97,65,37241000000,PELARRODRÍGUEZ
37,242,74,44,30,37242000000,PELAYOS
37,243,72,40,32,37243000000,LA PEÑA (LA)
37,244,155,74,81,37244000000,PEÑACABALLERA
37,245,319,163,156,37245000000,PEÑAPARDA
37,246,6079,2985,3094,37246000000,PEÑARANDA DE BRACAMONTE
37,247,184,103,81,37247000000,PEÑARANDILLA
37,248,168,92,76,37248000000,PERALEJOS DE ABAJO
37,249,35,23,12,37249000000,PERALEJOS DE ARRIBA
37,250,312,171,141,37250000000,PEREÑA DE LA RIBERA
37,251,122,60,62,37251000000,PEROMINGO
37,252,106,63,43,37252000000,PINEDAS
37,253,155,87,68,37253000000,EL PINO DE TORMES (EL)
37,254,179,101,78,37254000000,PITIEGUA
37,255,60,37,23,37255000000,PIZARRAL
37,256,197,113,84,37256000000,POVEDA DE LAS CINTAS
37,257,54,29,25,37257000000,POZOS DE HINOJO
37,258,145,82,63,37258000000,PUEBLA DE AZABA
37,259,33,18,15,37259000000,PUEBLA DE SAN MEDEL
37,260,142,76,66,37260000000,PUEBLA DE YELTES
37,261,223,130,93,37261000000,PUENTE DEL CONGOSTO
37,262,67,40,27,37262000000,PUERTAS
37,263,360,174,186,37263000000,PUERTO DE BÉJAR
37,264,68,31,37,37264000000,PUERTO SEGURO
37,265,204,100,104,37265000000,RÁGAMA
37,266,64,37,27,37266000000,LA REDONDA (LA)
37,267,174,91,83,37267000000,RETORTILLO
37,268,108,64,44,37268000000,LA RINCONADA DE LA SIERRA (LA)
37,269,462,256,206,37269000000,ROBLEDA
37,270,190,103,87,37270000000,ROBLIZA DE COJOS
37,271,341,192,149,37271000000,ROLLÁN
37,272,173,98,75,37272000000,SAELICES EL CHICO
37,273,84,46,38,37273000000,LA SAGRADA (LA)
37,274,143954,65035,78919,37274000000,SALAMANCA
37,275,105,63,42,37275000000,SALDEANA
37,276,114,68,46,37276000000,SALMORAL
37,277,78,39,39,37277000000,SALVATIERRA DE TORMES
37,278,1114,581,533,37278000000,SAN CRISTÓBAL DE LA CUESTA
37,279,738,399,339,37279000000,SANCTI-SPÍRITUS
37,280,70,35,35,37280000000,SANCHÓN DE LA RIBERA
37,281,36,21,15,37281000000,SANCHÓN DE LA SAGRADA
37,282,222,113,109,37282000000,SANCHOTELLO
37,283,118,69,49,37283000000,SANDO
37,284,371,211,160,37284000000,SAN ESTEBAN DE LA SIERRA
37,285,354,190,164,37285000000,SAN FELICES DE LOS GALLEGOS
37,286,240,131,109,37286000000,SAN MARTÍN DEL CASTAÑAR
37,287,316,167,149,37287000000,SAN MIGUEL DE VALERO
37,288,354,190,164,37288000000,SAN MORALES
37,289,211,103,108,37289000000,SAN MUÑOZ
37,290,149,86,63,37290000000,SAN PEDRO DEL VALLE
37,291,277,156,121,37291000000,SAN PEDRO DE ROZADOS
37,292,92,53,39,37292000000,SAN PELAYO DE GUAREÑA
37,293,98,50,48,37293000000,SANTA MARÍA DE SANDO
37,294,14683,7130,7553,37294000000,SANTA MARTA DE TORMES
37,296,290,151,139,37296000000,SANTIAGO DE LA PUEBLA
37,297,452,228,224,37297000000,SANTIBÁÑEZ DE BÉJAR
37,298,157,90,67,37298000000,SANTIBÁÑEZ DE LA SIERRA
37,299,246,135,111,37299000000,SANTIZ
37,300,592,298,294,37300000000,LOS SANTOS (LOS)
37,301,98,54,44,37301000000,SARDÓN DE LOS FRAILES
37,302,254,129,125,37302000000,SAUCELLE
37,303,177,98,79,37303000000,EL SAHUGO (EL)
37,304,164,90,74,37304000000,SEPULCRO-HILARIO
37,305,215,100,115,37305000000,SEQUEROS
37,306,248,135,113,37306000000,SERRADILLA DEL ARROYO
37,307,145,81,64,37307000000,SERRADILLA DEL LLANO
37,309,41,20,21,37309000000,LA SIERPE (LA)
37,310,175,83,92,37310000000,SIETEIGLESIAS DE TORMES
37,311,182,93,89,37311000000,SOBRADILLO
37,312,256,134,122,37312000000,SORIHUELA
37,313,525,277,248,37313000000,SOTOSERRANO
37,314,102,56,46,37314000000,TABERA DE ABAJO
37,315,78,42,36,37315000000,LA TALA (LA)
37,316,792,398,394,37316000000,TAMAMES
37,317,272,150,122,37317000000,TARAZONA DE GUAREÑA
37,318,192,120,72,37318000000,TARDÁGUILA
37,319,91,52,39,37319000000,EL TEJADO (EL)
37,320,94,52,42,37320000000,TEJEDA Y SEGOYUELA
37,321,133,73,60,37321000000,TENEBRÓN
37,322,3104,1544,1560,37322000000,TERRADILLOS
37,323,512,267,245,37323000000,TOPAS
37,324,324,174,150,37324000000,TORDILLOS
37,325,87,51,36,37325000000,EL TORNADIZO (EL)
37,327,185,102,83,37327000000,TORRESMENUDAS
37,328,175,85,90,37328000000,TRABANCA
37,329,37,20,17,37329000000,TREMEDAL DE TORMES
37,330,314,160,154,37330000000,VALDECARROS
37,331,187,104,83,37331000000,VALDEFUENTES DE SANGUSÍN
37,332,83,45,38,37332000000,VALDEHIJADEROS
37,333,198,114,84,37333000000,VALDELACASA
37,334,70,39,31,37334000000,VALDELAGEVE
37,335,417,213,204,37335000000,VALDELOSA
37,336,58,37,21,37336000000,VALDEMIERQUE
37,337,133,70,63,37337000000,VALDERRODRIGO
37,338,101,53,48,37338000000,VALDUNCIEL
37,339,301,172,129,37339000000,VALERO
37,340,119,66,53,37340000000,VALSALABROSO
37,341,54,27,27,37341000000,VALVERDE DE VALDELACASA
37,342,267,137,130,37342000000,VALVERDÓN
37,343,67,38,29,37343000000,VALLEJERA DE RIOFRÍO
37,344,226,112,114,37344000000,VECINOS
37,345,159,81,78,37345000000,VEGA DE TIRADOS
37,346,274,136,138,37346000000,LAS VEGUILLAS (LAS)
37,347,517,278,239,37347000000,LA VELLÉS (LA)
37,348,104,57,47,37348000000,VENTOSA DEL RÍO ALMAR
37,349,112,56,56,37349000000,LA VÍDOLA (LA)
37,350,394,199,195,37350000000,VILVESTRE
37,351,260,130,130,37351000000,VILLAFLORES
37,352,226,140,86,37352000000,VILLAGONZALO DE TORMES
37,353,113,65,48,37353000000,VILLALBA DE LOS LLANOS
37,354,7539,3754,3785,37354000000,VILLAMAYOR
37,355,179,93,86,37355000000,VILLANUEVA DEL CONDE
37,356,98,55,43,37356000000,VILLAR DE ARGAÑÁN
37,357,266,144,122,37357000000,VILLAR DE CIERVO
37,358,195,126,69,37358000000,VILLAR DE GALLIMAZO
37,359,159,87,72,37359000000,VILLAR DE LA YEGUA
37,360,209,107,102,37360000000,VILLAR DE PERALONSO
37,361,79,45,34,37361000000,VILLAR DE SAMANIEGO
37,362,6576,3229,3347,37362000000,VILLARES DE LA REINA
37,363,101,48,53,37363000000,VILLARES DE YELTES
37,364,775,407,368,37364000000,VILLARINO DE LOS AIRES
37,365,165,93,72,37365000000,VILLARMAYOR
37,366,39,27,12,37366000000,VILLARMUERTO
37,367,168,93,75,37367000000,VILLASBUENAS
37,368,23,8,15,37368000000,VILLASDARDO
37,369,130,73,57,37369000000,VILLASECO DE LOS GAMITOS
37,370,296,173,123,37370000000,VILLASECO DE LOS REYES
37,371,245,131,114,37371000000,VILLASRUBIAS
37,372,140,75,65,37372000000,VILLAVERDE DE GUAREÑA
37,373,696,370,326,37373000000,VILLAVIEJA DE YELTES
37,374,1267,647,620,37374000000,VILLORIA
37,375,738,372,366,37375000000,VILLORUELA
37,376,2363,1135,1228,37376000000,VITIGUDINO
37,377,221,114,107,37377000000,YECLA DE YELTES
37,378,75,43,32,37378000000,ZAMARRA
37,379,191,116,75,37379000000,ZAMAYÓN
37,380,60,36,24,37380000000,ZARAPICOS
37,381,138,84,54,37381000000,LA ZARZA DE PUMAREDA (LA)
37,382,152,74,78,37382000000,ZORITA DE LA FRONTERA
38,001,50167,25085,25082,38001000000,ADEJE
38,002,1113,555,558,38002000000,AGULO
38,003,2056,1084,972,38003000000,ALAJERÓ
38,004,5712,2878,2834,38004000000,ARAFO
38,005,9020,4640,4380,38005000000,ARICO
38,006,85249,42981,42268,38006000000,ARONA
38,007,1944,983,961,38007000000,BARLOVENTO
38,008,7305,3560,3745,38008000000,BREÑA ALTA
38,009,5963,3023,2940,38009000000,BREÑA BAJA
38,010,4710,2344,2366,38010000000,BUENAVISTA DEL NORTE
38,011,28694,13816,14878,38011000000,CANDELARIA
38,012,2984,1567,1417,38012000000,FASNIA
38,013,4465,2236,2229,38013000000,FRONTERA
38,014,1841,927,914,38014000000,FUENCALIENTE DE LA PALMA
38,015,4936,2463,2473,38015000000,GARACHICO
38,016,1916,993,923,38016000000,GARAFÍA
38,017,54942,27299,27643,38017000000,GRANADILLA DE ABONA
38,018,5562,2723,2839,38018000000,LA GUANCHA (LA)
38,019,22301,11091,11210,38019000000,GUÍA DE ISORA
38,020,21536,10610,10926,38020000000,GÜÍMAR
38,021,1838,961,877,38021000000,HERMIGUA
38,022,23971,11734,12237,38022000000,ICOD DE LOS VINOS
38,023,159034,76428,82606,38023000000,SAN CRISTÓBAL DE LA LAGUNA
38,024,20189,9780,10409,38024000000,LOS LLANOS DE ARIDANE (LOS)
38,025,9092,4545,4547,38025000000,LA MATANZA DE ACENTEJO (LA)
38,026,42454,20744,21710,38026000000,LA OROTAVA (LA)
38,027,7967,3971,3996,38027000000,EL PASO (EL)
38,028,30849,15066,15783,38028000000,PUERTO DE LA CRUZ
38,029,2320,1176,1144,38029000000,PUNTAGORDA
38,030,2605,1297,1308,38030000000,PUNTALLANA
38,031,37207,18230,18977,38031000000,LOS REALEJOS (LOS)
38,032,17866,9064,8802,38032000000,EL ROSARIO (EL)
38,033,4219,2106,2113,38033000000,SAN ANDRÉS Y SAUCES
38,034,4908,2454,2454,38034000000,SAN JUAN DE LA RAMBLA
38,035,22606,11347,11259,38035000000,SAN MIGUEL DE ABONA
38,036,9501,4732,4769,38036000000,SAN SEBASTIÁN DE LA GOMERA
38,037,15441,7379,8062,38037000000,SANTA CRUZ DE LA PALMA
38,038,209395,99515,109880,38038000000,SANTA CRUZ DE TENERIFE
38,039,15285,7547,7738,38039000000,SANTA ÚRSULA
38,040,11972,5934,6038,38040000000,SANTIAGO DEL TEIDE
38,041,9145,4553,4592,38041000000,EL SAUZAL (EL)
38,042,4679,2340,2339,38042000000,LOS SILOS (LOS)
38,043,24652,12279,12373,38043000000,TACORONTE
38,044,2784,1343,1441,38044000000,EL TANQUE (EL)
38,045,4575,2353,2222,38045000000,TAZACORTE
38,046,11344,5583,5761,38046000000,TEGUESTE
38,047,2640,1334,1306,38047000000,TIJARAFE
38,048,5165,2579,2586,38048000000,VALVERDE
38,049,4719,2397,2322,38049000000,VALLE GRAN REY
38,050,2935,1522,1413,38050000000,VALLEHERMOSO
38,051,9228,4566,4662,38051000000,LA VICTORIA DE ACENTEJO (LA)
38,052,1823,921,902,38052000000,VILAFLOR DE CHASNA
38,053,4950,2515,2435,38053000000,VILLA DE MAZO
38,901,2016,1051,965,38901000000,EL PINAR DE EL HIERRO (EL)
39,001,2471,1276,1195,39001000000,ALFOZ DE LLOREDO
39,002,4455,2230,2225,39002000000,AMPUERO
39,003,268,146,122,39003000000,ANIEVAS
39,004,1742,880,862,39004000000,ARENAS DE IGUÑA
39,005,1860,945,915,39005000000,ARGOÑOS
39,006,2255,1135,1120,39006000000,ARNUERO
39,007,478,270,208,39007000000,ARREDONDO
39,008,18220,8878,9342,39008000000,EL ASTILLERO (EL)
39,009,4653,2382,2271,39009000000,BÁRCENA DE CICERO
39,010,674,343,331,39010000000,BÁRCENA DE PIE DE CONCHA
39,011,2144,1067,1077,39011000000,BAREYO
39,012,8181,3909,4272,39012000000,CABEZÓN DE LA SAL
39,013,565,320,245,39013000000,CABEZÓN DE LIÉBANA
39,014,995,518,477,39014000000,CABUÉRNIGA
39,015,963,536,427,39015000000,CAMALEÑO
39,016,30349,14817,15532,39016000000,CAMARGO
39,017,680,359,321,39017000000,CAMPOO DE YUSO
39,018,5800,2890,2910,39018000000,CARTES
39,019,3160,1605,1555,39019000000,CASTAÑEDA
39,020,33225,16407,16818,39020000000,CASTRO-URDIALES
39,021,552,281,271,39021000000,CIEZA
39,022,1344,708,636,39022000000,CILLORIGO DE LIÉBANA
39,023,8549,4185,4364,39023000000,COLINDRES
39,024,2135,1012,1123,39024000000,COMILLAS
39,025,10785,5267,5518,39025000000,LOS CORRALES DE BUELNA (LOS)
39,026,2096,1052,1044,39026000000,CORVERA DE TORANZO
39,027,3763,1923,1840,39027000000,CAMPOO DE ENMEDIO
39,028,5568,2778,2790,39028000000,ENTRAMBASAGUAS
39,029,749,382,367,39029000000,ESCALANTE
39,030,2438,1271,1167,39030000000,GURIEZO
39,031,1782,879,903,39031000000,HAZAS DE CESTO
39,032,1588,874,714,39032000000,HERMANDAD DE CAMPOO DE SUSO
39,033,600,339,261,39033000000,HERRERÍAS
39,034,257,161,96,39034000000,LAMASÓN
39,035,10849,5158,5691,39035000000,LAREDO
39,036,1242,639,603,39036000000,LIENDO
39,037,2397,1192,1205,39037000000,LIÉRGANES
39,038,1975,985,990,39038000000,LIMPIAS
39,039,622,337,285,39039000000,LUENA
39,040,5148,2562,2586,39040000000,MARINA DE CUDEYO
39,041,2083,1065,1018,39041000000,MAZCUERRAS
39,042,7696,3699,3997,39042000000,MEDIO CUDEYO
39,043,2230,1100,1130,39043000000,MERUELO
39,044,5199,2678,2521,39044000000,MIENGO
39,045,393,206,187,39045000000,MIERA
39,046,1476,724,752,39046000000,MOLLEDO
39,047,2741,1359,1382,39047000000,NOJA
39,048,2244,1133,1111,39048000000,PENAGOS
39,049,316,164,152,39049000000,PEÑARRUBIA
39,050,282,158,124,39050000000,PESAGUERO
39,051,70,44,26,39051000000,PESQUERA
39,052,26605,13175,13430,39052000000,PIÉLAGOS
39,053,210,134,76,39053000000,POLACIONES
39,054,6175,3059,3116,39054000000,POLANCO
39,055,1336,619,717,39055000000,POTES
39,056,2884,1470,1414,39056000000,PUENTE VIESGO
39,057,3027,1516,1511,39057000000,RAMALES DE LA VICTORIA
39,058,975,502,473,39058000000,RASINES
39,059,8570,4021,4549,39059000000,REINOSA
39,060,8422,4148,4274,39060000000,REOCÍN
39,061,4636,2369,2267,39061000000,RIBAMONTÁN AL MAR
39,062,2498,1261,1237,39062000000,RIBAMONTÁN AL MONTE
39,063,1034,575,459,39063000000,RIONANSA
39,064,1666,806,860,39064000000,RIOTUERTO
39,065,262,145,117,39065000000,LAS ROZAS DE VALDEARROYO (LAS)
39,066,1052,573,479,39066000000,RUENTE
39,067,809,446,363,39067000000,RUESGA
39,068,778,401,377,39068000000,RUILOBA
39,069,2390,1199,1191,39069000000,SAN FELICES DE BUELNA
39,070,178,91,87,39070000000,SAN MIGUEL DE AGUAYO
39,071,445,243,202,39071000000,SAN PEDRO DEL ROMERAL
39,072,351,208,143,39072000000,SAN ROQUE DE RIOMIERA
39,073,13689,6704,6985,39073000000,SANTA CRUZ DE BEZANA
39,074,9316,4631,4685,39074000000,SANTA MARÍA DE CAYÓN
39,075,172726,79525,93201,39075000000,SANTANDER
39,076,4245,2064,2181,39076000000,SANTILLANA DEL MAR
39,077,247,142,105,39077000000,SANTIURDE DE REINOSA
39,078,1732,910,822,39078000000,SANTIURDE DE TORANZO
39,079,10892,5291,5601,39079000000,SANTOÑA
39,080,4038,1963,2075,39080000000,SAN VICENTE DE LA BARQUERA
39,081,518,271,247,39081000000,SARO
39,082,1845,939,906,39082000000,SELAYA
39,083,1108,623,485,39083000000,SOBA
39,084,1080,575,505,39084000000,SOLÓRZANO
39,085,9091,4454,4637,39085000000,SUANCES
39,086,380,227,153,39086000000,LOS TOJOS (LOS)
39,087,51361,24196,27165,39087000000,TORRELAVEGA
39,088,58,38,20,39088000000,TRESVISO
39,089,155,105,50,39089000000,TUDANCA
39,090,945,473,472,39090000000,UDÍAS
39,091,2167,1117,1050,39091000000,VALDÁLIGA
39,092,882,480,402,39092000000,VALDEOLEA
39,093,331,189,142,39093000000,VALDEPRADO DEL RÍO
39,094,954,545,409,39094000000,VALDERREDIBLE
39,095,2783,1416,1367,39095000000,VAL DE SAN VICENTE
39,096,702,373,329,39096000000,VEGA DE LIÉBANA
39,097,741,398,343,39097000000,VEGA DE PAS
39,098,1674,866,808,39098000000,VILLACARRIEDO
39,099,3949,1960,1989,39099000000,VILLAESCUSA
39,100,999,518,481,39100000000,VILLAFUFRE
39,101,254,144,110,39101000000,VALLE DE VILLAVERDE
39,102,2947,1554,1393,39102000000,VOTO
40,001,859,421,438,40001000000,ABADES
40,002,38,22,16,40002000000,ADRADA DE PIRÓN
40,003,122,71,51,40003000000,ADRADOS
40,004,562,287,275,40004000000,AGUILAFUENTE
40,005,24,15,9,40005000000,ALCONADA DE MADERUELO
40,006,18,11,7,40006000000,ALDEALCORVO
40,007,83,50,33,40007000000,ALDEALENGUA DE PEDRAZA
40,008,66,34,32,40008000000,ALDEALENGUA DE SANTA MARÍA
40,009,42,29,13,40009000000,ALDEANUEVA DE LA SERREZUELA
40,010,110,59,51,40010000000,ALDEANUEVA DEL CODONAL
40,012,281,148,133,40012000000,ALDEA REAL
40,013,64,36,28,40013000000,ALDEASOÑA
40,014,55,32,23,40014000000,ALDEHORNO
40,015,23,12,11,40015000000,ALDEHUELA DEL CODONAL
40,016,55,32,23,40016000000,ALDEONTE
40,017,120,61,59,40017000000,ANAYA
40,018,69,41,28,40018000000,AÑE
40,019,25,18,7,40019000000,ARAHUETES
40,020,191,99,92,40020000000,ARCONES
40,021,18,12,6,40021000000,AREVALILLO DE CEGA
40,022,238,135,103,40022000000,ARMUÑA
40,024,1124,585,539,40024000000,AYLLÓN
40,025,143,85,58,40025000000,BARBOLLA
40,026,148,73,75,40026000000,BASARDILLA
40,028,107,56,51,40028000000,BERCIAL
40,029,34,20,14,40029000000,BERCIMUEL
40,030,475,264,211,40030000000,BERNARDOS
40,031,1059,547,512,40031000000,BERNUY DE PORREROS
40,032,699,354,345,40032000000,BOCEGUILLAS
40,033,91,53,38,40033000000,BRIEVA
40,034,74,44,30,40034000000,CABALLAR
40,035,203,106,97,40035000000,CABAÑAS DE POLENDOS
40,036,626,328,298,40036000000,CABEZUELA
40,037,25,16,9,40037000000,CALABAZAS DE FUENTIDUEÑA
40,039,255,145,110,40039000000,CAMPO DE SAN PEDRO
40,040,3546,1774,1772,40040000000,CANTALEJO
40,041,1364,727,637,40041000000,CANTIMPALOS
40,043,2492,1277,1215,40043000000,CARBONERO EL MAYOR
40,044,137,74,63,40044000000,CARRASCAL DEL RÍO
40,045,155,83,72,40045000000,CASLA
40,046,111,63,48,40046000000,CASTILLEJO DE MESLEÓN
40,047,46,29,17,40047000000,CASTRO DE FUENTIDUEÑA
40,048,31,16,15,40048000000,CASTROJIMENO
40,049,36,21,15,40049000000,CASTROSERNA DE ABAJO
40,051,35,18,17,40051000000,CASTROSERRACÍN
40,052,85,45,40,40052000000,CEDILLO DE LA TORRE
40,053,126,69,57,40053000000,CEREZO DE ABAJO
40,054,134,72,62,40054000000,CEREZO DE ARRIBA
40,055,33,22,11,40055000000,CILLERUELO DE SAN MAMÉS
40,056,36,16,20,40056000000,COBOS DE FUENTIDUEÑA
40,057,1741,871,870,40057000000,COCA
40,058,317,162,155,40058000000,CODORNIZ
40,059,128,69,59,40059000000,COLLADO HERMOSO
40,060,85,47,38,40060000000,CONDADO DE CASTILNOVO
40,061,75,42,33,40061000000,CORRAL DE AYLLÓN
40,062,72,46,26,40062000000,CUBILLO
40,063,9608,4827,4781,40063000000,CUÉLLAR
40,065,699,356,343,40065000000,CHAÑE
40,068,32,18,14,40068000000,DOMINGO GARCÍA
40,069,86,47,39,40069000000,DONHIERRO
40,070,160,98,62,40070000000,DURUELO
40,071,37,19,18,40071000000,ENCINAS
40,072,340,188,152,40072000000,ENCINILLAS
40,073,475,253,222,40073000000,ESCALONA DEL PRADO
40,074,281,149,132,40074000000,ESCARABAJOSA DE CABEZAS
40,075,176,97,79,40075000000,ESCOBAR DE POLENDOS
40,076,9814,4934,4880,40076000000,EL ESPINAR (EL)
40,077,1543,796,747,40077000000,ESPIRDO
40,078,174,103,71,40078000000,FRESNEDA DE CUÉLLAR
40,079,303,164,139,40079000000,FRESNO DE CANTESPINO
40,080,77,45,32,40080000000,FRESNO DE LA FUENTE
40,081,124,68,56,40081000000,FRUMALES
40,082,109,58,51,40082000000,FUENTE DE SANTA CRUZ
40,083,278,93,185,40083000000,FUENTE EL OLMO DE FUENTIDUEÑA
40,084,51,31,20,40084000000,FUENTE EL OLMO DE ÍSCAR
40,086,775,401,374,40086000000,FUENTEPELAYO
40,087,72,43,29,40087000000,FUENTEPIÑEL
40,088,316,169,147,40088000000,FUENTERREBOLLO
40,089,244,131,113,40089000000,FUENTESAÚCO DE FUENTIDUEÑA
40,091,96,57,39,40091000000,FUENTESOTO
40,092,144,82,62,40092000000,FUENTIDUEÑA
40,093,95,51,44,40093000000,GALLEGOS
40,094,519,280,239,40094000000,GARCILLÁN
40,095,636,326,310,40095000000,GOMEZSERRACÍN
40,097,256,144,112,40097000000,GRAJERA
40,099,52,31,21,40099000000,HONRUBIA DE LA CUESTA
40,100,302,167,135,40100000000,HONTALBILLA
40,101,1601,830,771,40101000000,HONTANARES DE ERESMA
40,103,171,91,80,40103000000,LOS HUERTOS (LOS)
40,104,437,223,214,40104000000,ITUERO Y LAMA
40,105,45,27,18,40105000000,JUARROS DE RIOMOROS
40,106,186,94,92,40106000000,JUARROS DE VOLTOYA
40,107,110,61,49,40107000000,LABAJOS
40,108,110,67,43,40108000000,LAGUNA DE CONTRERAS
40,109,83,48,35,40109000000,LANGUILLA
40,110,318,169,149,40110000000,LASTRAS DE CUÉLLAR
40,111,65,34,31,40111000000,LASTRAS DEL POZO
40,112,4559,2304,2255,40112000000,LA LASTRILLA (LA)
40,113,537,292,245,40113000000,LA LOSA (LA)
40,115,109,63,46,40115000000,MADERUELO
40,118,52,31,21,40118000000,MARAZUELA
40,119,248,147,101,40119000000,MARTÍN MIGUEL
40,120,317,164,153,40120000000,MARTÍN MUÑOZ DE LA DEHESA
40,121,259,147,112,40121000000,MARTÍN MUÑOZ DE LAS POSADAS
40,122,757,415,342,40122000000,MARUGÁN
40,123,203,118,85,40123000000,MATABUENA
40,124,266,142,124,40124000000,MATA DE CUÉLLAR
40,125,73,44,29,40125000000,LA MATILLA (LA)
40,126,69,40,29,40126000000,MELQUE DE CERCOS
40,127,46,24,22,40127000000,MEMBIBRE DE LA HOZ
40,128,131,73,58,40128000000,MIGUELÁÑEZ
40,129,163,92,71,40129000000,MONTEJO DE ARÉVALO
40,130,128,78,50,40130000000,MONTEJO DE LA VEGA DE LA SERREZUELA
40,131,61,33,28,40131000000,MONTERRUBIO
40,132,42,25,17,40132000000,MORAL DE HORNUEZ
40,134,880,488,392,40134000000,MOZONCILLO
40,135,306,158,148,40135000000,MUÑOPEDRO
40,136,142,69,73,40136000000,MUÑOVEROS
40,138,2753,1415,1338,40138000000,NAVA DE LA ASUNCIÓN
40,139,286,154,132,40139000000,NAVAFRÍA
40,140,96,51,45,40140000000,NAVALILLA
40,141,1040,553,487,40141000000,NAVALMANZANO
40,142,46,23,23,40142000000,NAVARES DE AYUSO
40,143,91,50,41,40143000000,NAVARES DE ENMEDIO
40,144,20,13,7,40144000000,NAVARES DE LAS CUEVAS
40,145,1272,650,622,40145000000,NAVAS DE ORO
40,146,371,206,165,40146000000,NAVAS DE SAN ANTONIO
40,148,249,123,126,40148000000,NIEVA
40,149,489,270,219,40149000000,OLOMBRADA
40,150,62,36,26,40150000000,OREJANA
40,151,49,25,24,40151000000,ORTIGOSA DE PESTAÑO
40,152,959,491,468,40152000000,OTERO DE HERREROS
40,154,26,14,12,40154000000,PAJAREJOS
40,155,5830,3018,2812,40155000000,PALAZUELOS DE ERESMA
40,156,358,203,155,40156000000,PEDRAZA
40,157,45,25,20,40157000000,PELAYOS DEL ARROYO
40,158,18,12,6,40158000000,PEROSILLO
40,159,178,102,76,40159000000,PINAREJOS
40,160,101,58,43,40160000000,PINARNEGRILLO
40,161,57,41,16,40161000000,CARABIAS
40,162,487,256,231,40162000000,PRÁDENA
40,163,51,28,23,40163000000,PUEBLA DE PEDRAZA
40,164,197,107,90,40164000000,RAPARIEGOS
40,165,75,38,37,40165000000,REBOLLO
40,166,307,151,156,40166000000,REMONDO
40,168,29,20,9,40168000000,RIAGUAS DE SAN BARTOLOMÉ
40,170,2150,1138,1012,40170000000,RIAZA
40,171,47,34,13,40171000000,RIBOTA
40,172,39,25,14,40172000000,RIOFRÍO DE RIAZA
40,173,250,131,119,40173000000,RODA DE ERESMA
40,174,352,173,179,40174000000,SACRAMENIA
40,176,464,246,218,40176000000,SAMBOAL
40,177,152,85,67,40177000000,SAN CRISTÓBAL DE CUÉLLAR
40,178,83,45,38,40178000000,SAN CRISTÓBAL DE LA VEGA
40,179,1012,503,509,40179000000,SANCHONUÑO
40,180,289,158,131,40180000000,SANGARCÍA
40,181,5183,2524,2659,40181000000,REAL SITIO DE SAN ILDEFONSO
40,182,232,114,118,40182000000,SAN MARTÍN Y MUDRIÁN
40,183,136,65,71,40183000000,SAN MIGUEL DE BERNUY
40,184,306,157,149,40184000000,SAN PEDRO DE GAÍLLOS
40,185,891,501,390,40185000000,SANTA MARÍA LA REAL DE NIEVA
40,186,56,29,27,40186000000,SANTA MARTA DEL CERRO
40,188,84,55,29,40188000000,SANTIUSTE DE PEDRAZA
40,189,534,290,244,40189000000,SANTIUSTE DE SAN JUAN BAUTISTA
40,190,48,26,22,40190000000,SANTO DOMINGO DE PIRÓN
40,191,248,140,108,40191000000,SANTO TOMÉ DEL PUERTO
40,192,141,81,60,40192000000,SAUQUILLO DE CABEZAS
40,193,254,134,120,40193000000,SEBÚLCOR
40,194,51011,23791,27220,40194000000,SEGOVIA
40,195,990,497,493,40195000000,SEPÚLVEDA
40,196,44,29,15,40196000000,SEQUERA DE FRESNO
40,198,30,16,14,40198000000,SOTILLO
40,199,135,76,59,40199000000,SOTOSALBOS
40,200,54,27,27,40200000000,TABANERA LA LUENGA
40,201,42,19,23,40201000000,TOLOCIRIO
40,202,52,28,24,40202000000,TORREADRADA
40,203,1454,748,706,40203000000,TORRECABALLEROS
40,204,180,97,83,40204000000,TORRECILLA DEL PINAR
40,205,256,129,127,40205000000,TORREIGLESIAS
40,206,190,99,91,40206000000,TORRE VAL DE SAN PEDRO
40,207,1103,570,533,40207000000,TRESCASAS
40,208,1004,519,485,40208000000,TURÉGANO
40,210,100,69,31,40210000000,URUEÑAS
40,211,61,34,27,40211000000,VALDEPRADOS
40,212,29,16,13,40212000000,VALDEVACAS DE MONTEJO
40,213,85,49,36,40213000000,VALDEVACAS Y GUIJAR
40,214,228,124,104,40214000000,VALSECA
40,215,78,49,29,40215000000,VALTIENDAS
40,216,1152,574,578,40216000000,VALVERDE DEL MAJANO
40,218,76,45,31,40218000000,VALLE DE TABLADILLO
40,219,702,368,334,40219000000,VALLELADO
40,220,80,38,42,40220000000,VALLERUELA DE PEDRAZA
40,221,54,25,29,40221000000,VALLERUELA DE SEPÚLVEDA
40,222,204,106,98,40222000000,VEGANZONES
40,223,329,192,137,40223000000,VEGAS DE MATUTE
40,224,15,10,5,40224000000,VENTOSILLA Y TEJADILLA
40,225,1530,777,753,40225000000,VILLACASTÍN
40,228,585,305,280,40228000000,VILLAVERDE DE ÍSCAR
40,229,24,16,8,40229000000,VILLAVERDE DE MONTEJO
40,230,123,68,55,40230000000,VILLEGUILLO
40,231,123,67,56,40231000000,YANGUAS DE ERESMA
40,233,494,253,241,40233000000,ZARZUELA DEL MONTE
40,234,410,216,194,40234000000,ZARZUELA DEL PINAR
40,901,576,293,283,40901000000,ORTIGOSA DEL MONTE
40,902,114,62,52,40902000000,COZUELOS DE FUENTIDUEÑA
40,903,97,65,32,40903000000,MARAZOLEJA
40,904,413,197,216,40904000000,NAVAS DE RIOFRÍO
40,905,127,74,53,40905000000,CUEVAS DE PROVANCO
40,906,3152,1588,1564,40906000000,SAN CRISTÓBAL DE SEGOVIA
41,001,2046,1017,1029,41001000000,AGUADULCE
41,002,1675,836,839,41002000000,ALANÍS
41,003,3254,1600,1654,41003000000,ALBAIDA DEL ALJARAFE
41,004,76547,37948,38599,41004000000,ALCALÁ DE GUADAÍRA
41,005,12288,6242,6046,41005000000,ALCALÁ DEL RÍO
41,006,3307,1648,1659,41006000000,ALCOLEA DEL RÍO
41,007,16618,8201,8417,41007000000,LA ALGABA (LA)
41,008,1251,651,600,41008000000,ALGÁMITAS
41,009,1324,689,635,41009000000,ALMADÉN DE LA PLATA
41,010,6537,3252,3285,41010000000,ALMENSILLA
41,011,19491,9666,9825,41011000000,ARAHAL
41,012,4820,2450,2370,41012000000,AZNALCÁZAR
41,013,6057,3077,2980,41013000000,AZNALCÓLLAR
41,014,3089,1596,1493,41014000000,BADOLATOSA
41,015,7324,3693,3631,41015000000,BENACAZÓN
41,016,11160,5540,5620,41016000000,BOLLULLOS DE LA MITACIÓN
41,017,22780,11260,11520,41017000000,BORMUJOS
41,018,12804,6359,6445,41018000000,BRENES
41,019,7098,3582,3516,41019000000,BURGUILLOS
41,020,16400,8173,8227,41020000000,LAS CABEZAS DE SAN JUAN (LAS)
41,021,28157,13791,14366,41021000000,CAMAS
41,022,5137,2571,2566,41022000000,LA CAMPANA (LA)
41,023,10782,5423,5359,41023000000,CANTILLANA
41,024,29551,14909,14642,41024000000,CARMONA
41,025,2597,1258,1339,41025000000,CARRIÓN DE LOS CÉSPEDES
41,026,5305,2716,2589,41026000000,CASARICHE
41,027,5107,2582,2525,41027000000,CASTILBLANCO DE LOS ARROYOS
41,028,2874,1474,1400,41028000000,CASTILLEJA DE GUZMÁN
41,029,17167,8313,8854,41029000000,CASTILLEJA DE LA CUESTA
41,030,622,313,309,41030000000,CASTILLEJA DEL CAMPO
41,031,1500,796,704,41031000000,EL CASTILLO DE LAS GUARDAS (EL)
41,032,4660,2294,2366,41032000000,CAZALLA DE LA SIERRA
41,033,5742,2846,2896,41033000000,CONSTANTINA
41,034,30887,15308,15579,41034000000,CORIA DEL RÍO
41,035,1215,584,631,41035000000,CORIPE
41,036,4690,2352,2338,41036000000,EL CORONIL (EL)
41,037,3996,2030,1966,41037000000,LOS CORRALES (LOS)
41,038,138981,68066,70915,41038000000,DOS HERMANAS
41,039,39530,19445,20085,41039000000,ÉCIJA
41,040,16505,8290,8215,41040000000,ESPARTINAS
41,041,12373,6110,6263,41041000000,ESTEPA
41,042,7217,3585,3632,41042000000,FUENTES DE ANDALUCÍA
41,043,825,420,405,41043000000,EL GARROBO (EL)
41,044,10388,5153,5235,41044000000,GELVES
41,045,7833,3889,3944,41045000000,GERENA
41,046,3686,1871,1815,41046000000,GILENA
41,047,13481,6600,6881,41047000000,GINES
41,048,2545,1278,1267,41048000000,GUADALCANAL
41,049,13682,6919,6763,41049000000,GUILLENA
41,050,6544,3259,3285,41050000000,HERRERA
41,051,3289,1687,1602,41051000000,HUÉVAR DEL ALJARAFE
41,052,3851,1963,1888,41052000000,LANTEJUELA
41,053,27727,13845,13882,41053000000,LEBRIJA
41,054,888,464,424,41054000000,LORA DE ESTEPA
41,055,18316,9034,9282,41055000000,LORA DEL RÍO
41,056,4608,2313,2295,41056000000,LA LUISIANA (LA)
41,057,297,149,148,41057000000,EL MADROÑO (EL)
41,058,24125,12044,12081,41058000000,MAIRENA DEL ALCOR
41,059,47541,23002,24539,41059000000,MAIRENA DEL ALJARAFE
41,060,19271,9539,9732,41060000000,MARCHENA
41,061,2577,1304,1273,41061000000,MARINALEDA
41,062,2642,1368,1274,41062000000,MARTÍN DE LA JARA
41,063,3559,1808,1751,41063000000,LOS MOLARES (LOS)
41,064,7003,3510,3493,41064000000,MONTELLANO
41,065,27229,13382,13847,41065000000,MORÓN DE LA FRONTERA
41,066,1523,751,772,41066000000,LAS NAVAS DE LA CONCEPCIÓN (LAS)
41,067,9427,4727,4700,41067000000,OLIVARES
41,068,17418,8665,8753,41068000000,OSUNA
41,069,38698,19277,19421,41069000000,LOS PALACIOS Y VILLAFRANCA (LOS)
41,070,9161,4582,4579,41070000000,PALOMARES DEL RÍO
41,071,6798,3371,3427,41071000000,PARADAS
41,072,5104,2535,2569,41072000000,PEDRERA
41,073,2054,1017,1037,41073000000,EL PEDROSO (EL)
41,074,3646,1834,1812,41074000000,PEÑAFLOR
41,075,14052,7039,7013,41075000000,PILAS
41,076,2542,1288,1254,41076000000,PRUNA
41,077,10884,5418,5466,41077000000,LA PUEBLA DE CAZALLA (LA)
41,078,2966,1452,1514,41078000000,LA PUEBLA DE LOS INFANTES (LA)
41,079,11862,5833,6029,41079000000,LA PUEBLA DEL RÍO (LA)
41,080,1523,766,757,41080000000,EL REAL DE LA JARA (EL)
41,081,40162,19965,20197,41081000000,LA RINCONADA (LA)
41,082,4222,2090,2132,41082000000,LA RODA DE ANDALUCÍA (LA)
41,083,1441,732,709,41083000000,EL RONQUILLO (EL)
41,084,3305,1655,1650,41084000000,EL RUBIO (EL)
41,085,5627,2727,2900,41085000000,SALTERAS
41,086,22472,10863,11609,41086000000,SAN JUAN DE AZNALFARACHE
41,087,14172,6972,7200,41087000000,SANLÚCAR LA MAYOR
41,088,608,317,291,41088000000,SAN NICOLÁS DEL PUERTO
41,089,8539,4224,4315,41089000000,SANTIPONCE
41,090,4246,2116,2130,41090000000,EL SAUCEJO (EL)
41,091,684025,323988,360037,41091000000,SEVILLA
41,092,9420,4677,4743,41092000000,TOCINA
41,093,25374,12499,12875,41093000000,TOMARES
41,094,9376,4674,4702,41094000000,UMBRETE
41,095,51718,25487,26231,41095000000,UTRERA
41,096,8029,3923,4106,41096000000,VALENCINA DE LA CONCEPCIÓN
41,097,4640,2277,2363,41097000000,VILLAMANRIQUE DE LA CONDESA
41,098,6814,3302,3512,41098000000,VILLANUEVA DEL ARISCAL
41,099,4939,2494,2445,41099000000,VILLANUEVA DEL RÍO Y MINAS
41,100,994,499,495,41100000000,VILLANUEVA DE SAN JUAN
41,101,7700,3910,3790,41101000000,VILLAVERDE DEL RÍO
41,102,19265,9567,9698,41102000000,EL VISO DEL ALCOR (EL)
41,901,3391,1678,1713,41901000000,CAÑADA ROSAL
41,902,5741,2854,2887,41902000000,ISLA MAYOR
41,903,8635,4346,4289,41903000000,EL CUERVO DE SEVILLA (EL)
41,904,2325,1159,1166,41904000000,EL PALMAR DE TROYA (EL)
42,001,376,189,187,42001000000,ABEJAR
42,003,61,35,26,42003000000,ADRADAS
42,004,3056,1564,1492,42004000000,ÁGREDA
42,006,198,131,67,42006000000,ALCONABA
42,007,114,63,51,42007000000,ALCUBILLA DE AVELLANEDA
42,008,58,37,21,42008000000,ALCUBILLA DE LAS PEÑAS
42,009,79,47,32,42009000000,ALDEALAFUENTE
42,010,21,15,6,42010000000,ALDEALICES
42,011,20,8,12,42011000000,ALDEALPOZO
42,012,25,16,9,42012000000,ALDEALSEÑOR
42,013,34,19,15,42013000000,ALDEHUELA DE PERIÁÑEZ
42,014,61,36,25,42014000000,LAS ALDEHUELAS (LAS)
42,015,26,16,10,42015000000,ALENTISQUE
42,016,21,14,7,42016000000,ALIUD
42,017,178,94,84,42017000000,ALMAJANO
42,018,125,75,50,42018000000,ALMALUEZ
42,019,620,346,274,42019000000,ALMARZA
42,020,5426,2782,2644,42020000000,ALMAZÁN
42,021,61,42,19,42021000000,ALMAZUL
42,022,225,141,84,42022000000,ALMENAR DE SORIA
42,023,53,33,20,42023000000,ALPANSEQUE
42,024,82,53,29,42024000000,ARANCÓN
42,025,1525,780,745,42025000000,ARCOS DE JALÓN
42,026,49,29,20,42026000000,ARENILLAS
42,027,69,44,25,42027000000,ARÉVALO DE LA SIERRA
42,028,109,57,52,42028000000,AUSEJO DE LA SIERRA
42,029,130,76,54,42029000000,BARAONA
42,030,107,67,40,42030000000,BARCA
42,031,26,15,11,42031000000,BARCONES
42,032,150,80,70,42032000000,BAYUBAS DE ABAJO
42,033,62,35,27,42033000000,BAYUBAS DE ARRIBA
42,034,46,23,23,42034000000,BERATÓN
42,035,852,444,408,42035000000,BERLANGA DE DUERO
42,036,41,21,20,42036000000,BLACOS
42,037,27,17,10,42037000000,BLIECOS
42,038,30,18,12,42038000000,BORJABAD
42,039,231,133,98,42039000000,BOROBIA
42,041,28,14,14,42041000000,BUBEROS
42,042,75,41,34,42042000000,BUITRAGO
42,043,5166,2574,2592,42043000000,BURGO DE OSMA-CIUDAD DE OSMA
42,044,51,30,21,42044000000,CABREJAS DEL CAMPO
42,045,301,171,130,42045000000,CABREJAS DEL PINAR
42,046,45,26,19,42046000000,CALATAÑAZOR
42,048,52,35,17,42048000000,CALTOJAR
42,049,102,63,39,42049000000,CANDILICHERA
42,050,27,19,8,42050000000,CAÑAMAQUE
42,051,20,12,8,42051000000,CARABANTES
42,052,15,10,5,42052000000,CARACENA
42,053,17,11,6,42053000000,CARRASCOSA DE ABAJO
42,054,20,15,5,42054000000,CARRASCOSA DE LA SIERRA
42,055,146,77,69,42055000000,CASAREJOS
42,056,38,23,15,42056000000,CASTILFRÍO DE LA SIERRA
42,057,156,87,69,42057000000,CASTILRUIZ
42,058,101,59,42,42058000000,CASTILLEJO DE ROBLEDO
42,059,24,12,12,42059000000,CENTENERA DE ANDALUZ
42,060,29,21,8,42060000000,CERBÓN
42,061,311,186,125,42061000000,CIDONES
42,062,15,11,4,42062000000,CIGUDOSA
42,063,40,26,14,42063000000,CIHUELA
42,064,71,38,33,42064000000,CIRIA
42,065,20,15,5,42065000000,CIRUJALES DEL RÍO
42,068,66,42,24,42068000000,COSCURITA
42,069,1582,826,756,42069000000,COVALEDA
42,070,24,16,8,42070000000,CUBILLA
42,071,170,101,69,42071000000,CUBO DE LA SOLANA
42,073,71,44,27,42073000000,CUEVA DE ÁGREDA
42,075,77,44,33,42075000000,DÉVANOS
42,076,181,102,79,42076000000,DEZA
42,078,1050,541,509,42078000000,DURUELO DE LA SIERRA
42,079,19,12,7,42079000000,ESCOBOSA DE ALMAZÁN
42,080,147,89,58,42080000000,ESPEJA DE SAN MARCELINO
42,081,136,71,65,42081000000,ESPEJÓN
42,082,13,8,5,42082000000,ESTEPA DE SAN JUAN
42,083,20,11,9,42083000000,FRECHILLA DE ALMAZÁN
42,084,22,13,9,42084000000,FRESNO DE CARACENA
42,085,153,90,63,42085000000,FUENTEARMEGIL
42,086,32,19,13,42086000000,FUENTECAMBRÓN
42,087,68,34,34,42087000000,FUENTECANTOS
42,088,64,36,28,42088000000,FUENTELMONGE
42,089,62,32,30,42089000000,FUENTELSAZ DE SORIA
42,090,80,47,33,42090000000,FUENTEPINILLA
42,092,53,31,22,42092000000,FUENTES DE MAGAÑA
42,093,47,30,17,42093000000,FUENTESTRÚN
42,094,767,406,361,42094000000,GARRAY
42,095,3014,1572,1442,42095000000,GOLMAYO
42,096,299,170,129,42096000000,GÓMARA
42,097,28,19,9,42097000000,GORMAZ
42,098,11,8,3,42098000000,HERRERA DE SORIA
42,100,26,18,8,42100000000,HINOJOSA DEL CAMPO
42,103,699,377,322,42103000000,LANGA DE DUERO
42,105,49,27,22,42105000000,LICERAS
42,106,13,9,4,42106000000,LA LOSILLA (LA)
42,107,67,42,25,42107000000,MAGAÑA
42,108,9,6,3,42108000000,MAJÁN
42,110,75,50,25,42110000000,MATALEBRERAS
42,111,260,145,115,42111000000,MATAMALA DE ALMAZÁN
42,113,679,350,329,42113000000,MEDINACELI
42,115,87,52,35,42115000000,MIÑO DE MEDINACELI
42,116,39,26,13,42116000000,MIÑO DE SAN ESTEBAN
42,117,161,92,69,42117000000,MOLINOS DE DUERO
42,118,18,15,3,42118000000,MOMBLONA
42,119,173,87,86,42119000000,MONTEAGUDO DE LAS VICARÍAS
42,120,148,93,55,42120000000,MONTEJO DE TIERMES
42,121,52,35,17,42121000000,MONTENEGRO DE CAMEROS
42,123,198,105,93,42123000000,MORÓN DE ALMAZÁN
42,124,55,37,18,42124000000,MURIEL DE LA FUENTE
42,125,75,48,27,42125000000,MURIEL VIEJO
42,127,38,20,18,42127000000,NAFRÍA DE UCERO
42,128,68,42,26,42128000000,NARROS
42,129,741,397,344,42129000000,NAVALENO
42,130,52,36,16,42130000000,NEPAS
42,131,50,29,21,42131000000,NOLAY
42,132,165,91,74,42132000000,NOVIERCAS
42,134,3782,1980,1802,42134000000,ÓLVEGA
42,135,62,40,22,42135000000,ONCALA
42,139,18,10,8,42139000000,PINILLA DEL CAMPO
42,140,13,10,3,42140000000,PORTILLO DE SORIA
42,141,107,65,42,42141000000,LA PÓVEDA DE SORIA (LA)
42,142,48,24,24,42142000000,POZALMURO
42,144,508,291,217,42144000000,QUINTANA REDONDA
42,145,130,76,54,42145000000,QUINTANAS DE GORMAZ
42,148,9,5,4,42148000000,QUIÑONERÍA
42,149,447,247,200,42149000000,LOS RÁBANOS (LOS)
42,151,36,19,17,42151000000,REBOLLAR
42,152,63,39,24,42152000000,RECUERDA
42,153,20,12,8,42153000000,RELLO
42,154,113,75,38,42154000000,RENIEBLAS
42,155,143,81,62,42155000000,RETORTILLO DE SORIA
42,156,25,15,10,42156000000,REZNOS
42,157,10,7,3,42157000000,LA RIBA DE ESCALOTE (LA)
42,158,130,78,52,42158000000,RIOSECO DE SORIA
42,159,45,30,15,42159000000,ROLLAMIENTA
42,160,259,142,117,42160000000,EL ROYO (EL)
42,161,140,78,62,42161000000,SALDUERO
42,162,2950,1564,1386,42162000000,SAN ESTEBAN DE GORMAZ
42,163,60,37,23,42163000000,SAN FELICES
42,164,1986,1014,972,42164000000,SAN LEONARDO DE YAGÜE
42,165,614,348,266,42165000000,SAN PEDRO MANRIQUE
42,166,57,32,25,42166000000,SANTA CRUZ DE YANGUAS
42,167,246,138,108,42167000000,SANTA MARÍA DE HUERTA
42,168,102,57,45,42168000000,SANTA MARÍA DE LAS HOYAS
42,171,116,64,52,42171000000,SERÓN DE NÁGIMA
42,172,32,18,14,42172000000,SOLIEDRA
42,173,40096,18901,21195,42173000000,SORIA
42,174,185,105,80,42174000000,SOTILLO DEL RINCÓN
42,175,31,15,16,42175000000,SUELLACABRAS
42,176,23,12,11,42176000000,TAJAHUERCE
42,177,56,34,22,42177000000,TAJUECO
42,178,102,66,36,42178000000,TALVEILA
42,181,424,226,198,42181000000,TARDELCUENDE
42,182,43,23,20,42182000000,TARODA
42,183,96,59,37,42183000000,TEJADO
42,184,48,31,17,42184000000,TORLENGUA
42,185,26,13,13,42185000000,TORREBLACOS
42,187,56,39,17,42187000000,TORRUBIA DE SORIA
42,188,53,26,27,42188000000,TRÉVAGO
42,189,85,48,37,42189000000,UCERO
42,190,82,44,38,42190000000,VADILLO
42,191,209,114,95,42191000000,VALDEAVELLANO DE TERA
42,192,37,27,10,42192000000,VALDEGEÑA
42,193,13,8,5,42193000000,VALDELAGUA DEL CERRO
42,194,141,69,72,42194000000,VALDEMALUQUE
42,195,92,52,40,42195000000,VALDENEBRO
42,196,8,3,5,42196000000,VALDEPRADO
42,197,63,35,28,42197000000,VALDERRODILLA
42,198,19,13,6,42198000000,VALTAJEROS
42,200,67,47,20,42200000000,VELAMAZÁN
42,201,28,18,10,42201000000,VELILLA DE LA SIERRA
42,202,16,10,6,42202000000,VELILLA DE LOS AJOS
42,204,50,36,14,42204000000,VIANA DE DUERO
42,205,77,47,30,42205000000,VILLACIERVOS
42,206,8,5,3,42206000000,VILLANUEVA DE GORMAZ
42,207,52,26,26,42207000000,VILLAR DEL ALA
42,208,24,14,10,42208000000,VILLAR DEL CAMPO
42,209,161,97,64,42209000000,VILLAR DEL RÍO
42,211,82,47,35,42211000000,LOS VILLARES DE SORIA (LOS)
42,212,65,44,21,42212000000,VILLASAYAS
42,213,23,15,8,42213000000,VILLASECA DE ARCIEL
42,215,853,443,410,42215000000,VINUESA
42,216,31,20,11,42216000000,VIZMANOS
42,217,36,24,12,42217000000,VOZMEDIANO
42,218,113,72,41,42218000000,YANGUAS
42,219,40,24,16,42219000000,YELO
43,001,974,506,468,43001000000,AIGUAMÚRCIA
43,002,2666,1362,1304,43002000000,ALBINYANA
43,003,535,288,247,43003000000,L'ALBIOL (L')
43,004,9827,4965,4862,43004000000,ALCANAR
43,005,5278,2614,2664,43005000000,ALCOVER
43,006,867,444,423,43006000000,ALDOVER
43,007,940,486,454,43007000000,L'ALEIXAR (L')
43,008,361,191,170,43008000000,ALFARA DE CARLES
43,009,1965,992,973,43009000000,ALFORJA
43,010,508,250,258,43010000000,ALIÓ
43,011,1310,658,652,43011000000,ALMOSTER
43,012,5693,2753,2940,43012000000,ALTAFULLA
43,013,7325,3714,3611,43013000000,L'AMETLLA DE MAR (L')
43,014,22270,11294,10976,43014000000,AMPOSTA
43,015,129,79,50,43015000000,ARBOLÍ
43,016,5713,2902,2811,43016000000,L'ARBOÇ (L')
43,017,133,75,58,43017000000,L'ARGENTERA (L')
43,018,455,218,237,43018000000,ARNES
43,019,1638,850,788,43019000000,ASCÓ
43,020,3356,1690,1666,43020000000,BANYERES DEL PENEDÈS
43,021,486,265,221,43021000000,BARBERÀ DE LA CONCA
43,022,1869,929,940,43022000000,BATEA
43,023,284,147,137,43023000000,BELLMUNT DEL PRIORAT
43,024,2368,1223,1145,43024000000,BELLVEI
43,025,733,357,376,43025000000,BENIFALLET
43,026,1159,631,528,43026000000,BENISSANET
43,027,207,118,89,43027000000,LA BISBAL DE FALSET (LA)
43,028,4148,2168,1980,43028000000,LA BISBAL DEL PENEDÈS (LA)
43,029,393,202,191,43029000000,BLANCAFORT
43,030,745,403,342,43030000000,BONASTRE
43,031,2194,1127,1067,43031000000,LES BORGES DEL CAMP (LES)
43,032,559,284,275,43032000000,BOT
43,033,1156,588,568,43033000000,BOTARELL
43,034,693,348,345,43034000000,BRÀFIM
43,035,304,168,136,43035000000,CABACÉS
43,036,1282,669,613,43036000000,CABRA DEL CAMP
43,037,30631,15345,15286,43037000000,CALAFELL
43,038,36496,17829,18667,43038000000,CAMBRILS
43,039,110,63,47,43039000000,CAPAFONTS
43,040,424,213,211,43040000000,CAPÇANES
43,041,241,119,122,43041000000,CASERES
43,042,3018,1518,1500,43042000000,CASTELLVELL DEL CAMP
43,043,5115,2671,2444,43043000000,EL CATLLAR (EL)
43,044,5623,2816,2807,43044000000,LA SÉNIA (LA)
43,045,161,93,68,43045000000,COLLDEJOU
43,046,120,60,60,43046000000,CONESA
43,047,6788,3490,3298,43047000000,CONSTANTÍ
43,048,1011,536,475,43048000000,CORBERA D'EBRE
43,049,993,529,464,43049000000,CORNUDELLA DE MONTSANT
43,050,4084,2054,2030,43050000000,CREIXELL
43,051,15278,7525,7753,43051000000,CUNIT
43,052,1164,574,590,43052000000,XERTA
43,053,225,122,103,43053000000,DUESAIGÜES
43,054,3733,1841,1892,43054000000,L'ESPLUGA DE FRANCOLÍ (L')
43,055,2809,1429,1380,43055000000,FALSET
43,056,874,434,440,43056000000,LA FATARELLA (LA)
43,057,38,23,15,43057000000,LA FEBRÓ (LA)
43,058,119,68,51,43058000000,LA FIGUERA (LA)
43,059,337,166,171,43059000000,FIGUEROLA DEL CAMP
43,060,3343,1684,1659,43060000000,FLIX
43,061,47,29,18,43061000000,FORÈS
43,062,411,222,189,43062000000,FREGINALS
43,063,715,369,346,43063000000,LA GALERA (LA)
43,064,3140,1592,1548,43064000000,GANDESA
43,065,547,277,270,43065000000,GARCIA
43,066,198,98,100,43066000000,ELS GARIDELLS (ELS)
43,067,794,420,374,43067000000,GINESTAR
43,068,614,306,308,43068000000,GODALL
43,069,237,134,103,43069000000,GRATALLOPS
43,070,267,136,131,43070000000,ELS GUIAMETS (ELS)
43,071,1169,595,574,43071000000,HORTA DE SANT JOAN
43,072,105,56,49,43072000000,EL LLOAR (EL)
43,073,97,51,46,43073000000,LLORAC
43,074,2391,1171,1220,43074000000,LLORENÇ DEL PENEDÈS
43,075,106,67,39,43075000000,MARGALEF
43,076,589,318,271,43076000000,MARÇÀ
43,077,544,274,270,43077000000,MAS DE BARBERANS
43,078,1137,591,546,43078000000,MASDENVERGE
43,079,576,319,257,43079000000,MASLLORENÇ
43,080,296,155,141,43080000000,LA MASÓ (LA)
43,081,856,443,413,43081000000,MASPUJOLS
43,082,466,252,214,43082000000,EL MASROIG (EL)
43,083,181,87,94,43083000000,EL MILÀ (EL)
43,084,690,365,325,43084000000,MIRAVET
43,085,314,156,158,43085000000,EL MOLAR (EL)
43,086,7456,3797,3659,43086000000,MONTBLANC
43,088,3086,1594,1492,43088000000,MONTBRIÓ DEL CAMP
43,089,435,235,200,43089000000,MONTFERRI
43,090,1887,1008,879,43090000000,EL MONTMELL (EL)
43,091,183,102,81,43091000000,MONT-RAL
43,092,13592,6962,6630,43092000000,MONT-ROIG DEL CAMP
43,093,5649,2852,2797,43093000000,MÓRA D'EBRE
43,094,3244,1626,1618,43094000000,MÓRA LA NOVA
43,095,3893,2012,1881,43095000000,EL MORELL (EL)
43,096,153,87,66,43096000000,LA MORERA DE MONTSANT (LA)
43,097,635,313,322,43097000000,LA NOU DE GAIÀ (LA)
43,098,544,286,258,43098000000,NULLES
43,099,341,165,176,43099000000,LA PALMA D'EBRE (LA)
43,100,4963,2492,2471,43100000000,ELS PALLARESOS (ELS)
43,101,180,106,74,43101000000,PASSANANT I BELLTALL
43,102,555,282,273,43102000000,PAÜLS
43,103,1292,667,625,43103000000,PERAFORT
43,104,2915,1505,1410,43104000000,EL PERELLÓ (EL)
43,105,229,128,101,43105000000,LES PILES (LES)
43,106,1006,508,498,43106000000,EL PINELL DE BRAI (EL)
43,107,509,266,243,43107000000,PIRA
43,108,2395,1227,1168,43108000000,EL PLA DE SANTA MARIA (EL)
43,109,4076,2052,2024,43109000000,LA POBLA DE MAFUMET (LA)
43,110,341,192,149,43110000000,LA POBLA DE MASSALUCA (LA)
43,111,3221,1659,1562,43111000000,LA POBLA DE MONTORNÈS (LA)
43,112,330,166,164,43112000000,POBOLEDA
43,113,490,243,247,43113000000,EL PONT D'ARMENTERA (EL)
43,114,435,223,212,43114000000,PORRERA
43,115,171,87,84,43115000000,PRADELL DE LA TEIXETA
43,116,656,350,306,43116000000,PRADES
43,117,188,99,89,43117000000,PRAT DE COMTE
43,118,723,372,351,43118000000,PRATDIP
43,119,1215,631,584,43119000000,PUIGPELAT
43,120,584,326,258,43120000000,QUEROL
43,121,804,396,408,43121000000,RASQUERA
43,122,158,83,75,43122000000,RENAU
43,123,108479,52592,55887,43123000000,REUS
43,124,572,318,254,43124000000,LA RIBA (LA)
43,125,1150,617,533,43125000000,RIBA-ROJA D'EBRE
43,126,1778,891,887,43126000000,LA RIERA DE GAIÀ (LA)
43,127,1349,704,645,43127000000,RIUDECANYES
43,128,1211,619,592,43128000000,RIUDECOLS
43,129,6810,3457,3353,43129000000,RIUDOMS
43,130,243,133,110,43130000000,ROCAFORT DE QUERALT
43,131,7829,3962,3867,43131000000,RODA DE BERÀ
43,132,526,284,242,43132000000,RODONYÀ
43,133,8302,4276,4026,43133000000,ROQUETES
43,134,385,196,189,43134000000,EL ROURELL (EL)
43,135,542,283,259,43135000000,SALOMÓ
43,136,15046,7330,7716,43136000000,LA RÀPITA (LA)
43,137,2785,1422,1363,43137000000,SANT JAUME DELS DOMENYS
43,138,3758,1915,1843,43138000000,SANTA BÀRBARA
43,139,2805,1415,1390,43139000000,SANTA COLOMA DE QUERALT
43,140,3657,1865,1792,43140000000,SANTA OLIVA
43,141,128,72,56,43141000000,PONTILS
43,142,1606,808,798,43142000000,SARRAL
43,143,53,28,25,43143000000,SAVALLÀ DEL COMTAT
43,144,1800,904,896,43144000000,LA SECUITA (LA)
43,145,5736,2847,2889,43145000000,LA SELVA DEL CAMP (LA)
43,146,44,28,16,43146000000,SENAN
43,147,629,338,291,43147000000,SOLIVELLA
43,148,138262,67247,71015,43148000000,TARRAGONA
43,149,915,468,447,43149000000,TIVENYS
43,150,1635,831,804,43150000000,TIVISSA
43,151,120,65,55,43151000000,LA TORRE DE FONTAUBELLA (LA)
43,152,619,319,300,43152000000,LA TORRE DE L'ESPANYOL (LA)
43,153,17670,8629,9041,43153000000,TORREDEMBARRA
43,154,139,76,63,43154000000,TORROJA DEL PRIORAT
43,155,34639,17329,17310,43155000000,TORTOSA
43,156,6417,3381,3036,43156000000,ULLDECONA
43,157,418,230,188,43157000000,ULLDEMOLINS
43,158,95,59,36,43158000000,VALLCLARA
43,159,93,54,39,43159000000,VALLFOGONA DE RIUCORB
43,160,1942,979,963,43160000000,VALLMOLL
43,161,25014,12646,12368,43161000000,VALLS
43,162,6984,3458,3526,43162000000,VANDELLÒS I L'HOSPITALET DE L'INFANT
43,163,39601,19586,20015,43163000000,EL VENDRELL (EL)
43,164,494,262,232,43164000000,VESPELLA DE GAIÀ
43,165,723,369,354,43165000000,VILABELLA
43,166,2423,1222,1201,43166000000,VILALLONGA DEL CAMP
43,167,594,306,288,43167000000,VILANOVA D'ESCORNALBOU
43,168,113,60,53,43168000000,VILANOVA DE PRADES
43,169,552,294,258,43169000000,VILAPLANA
43,170,1362,720,642,43170000000,VILA-RODONA
43,171,23176,11642,11534,43171000000,VILA-SECA
43,172,477,253,224,43172000000,VILAVERD
43,173,128,71,57,43173000000,LA VILELLA ALTA (LA)
43,174,197,108,89,43174000000,LA VILELLA BAIXA (LA)
43,175,619,311,308,43175000000,VILALBA DELS ARCS
43,176,900,480,420,43176000000,VIMBODÍ I POBLET
43,177,415,219,196,43177000000,VINEBRE
43,178,2323,1206,1117,43178000000,VINYOLS I ELS ARCS
43,901,11818,5945,5873,43901000000,DELTEBRE
43,902,3661,1844,1817,43902000000,SANT JAUME D'ENVEJA
43,903,3332,1709,1623,43903000000,CAMARLES
43,904,4445,2402,2043,43904000000,L'ALDEA (L')
43,905,30224,15390,14834,43905000000,SALOU
43,906,3603,1829,1774,43906000000,L'AMPOLLA (L')
43,907,5922,2890,3032,43907000000,LA CANONJA (LA)
44,001,70,43,27,44001000000,ABABUJ
44,002,55,35,20,44002000000,ABEJUELA
44,003,15,7,8,44003000000,AGUATÓN
44,004,565,269,296,44004000000,AGUAVIVA
44,005,83,43,40,44005000000,AGUILAR DEL ALFAMBRA
44,006,212,110,102,44006000000,ALACÓN
44,007,187,110,77,44007000000,ALBA
44,008,1955,1016,939,44008000000,ALBALATE DEL ARZOBISPO
44,009,1015,515,500,44009000000,ALBARRACÍN
44,010,302,160,142,44010000000,ALBENTOSA
44,011,48,31,17,44011000000,ALCAINE
44,012,382,207,175,44012000000,ALCALÁ DE LA SELVA
44,013,16151,8061,8090,44013000000,ALCAÑIZ
44,014,3243,1654,1589,44014000000,ALCORISA
44,016,482,259,223,44016000000,ALFAMBRA
44,017,343,200,143,44017000000,ALIAGA
44,018,17,12,5,44018000000,ALMOHAJA
44,019,71,45,26,44019000000,ALOBRAS
44,020,25,15,10,44020000000,ALPEÑÉS
44,021,121,61,60,44021000000,ALLEPUZ
44,022,540,275,265,44022000000,ALLOZA
44,023,27,17,10,44023000000,ALLUEVA
44,024,33,21,12,44024000000,ANADÓN
44,025,7214,3581,3633,44025000000,ANDORRA
44,026,116,71,45,44026000000,ARCOS DE LAS SALINAS
44,027,205,99,106,44027000000,ARENS DE LLEDÓ
44,028,193,98,95,44028000000,ARGENTE
44,029,649,332,317,44029000000,ARIÑO
44,031,98,57,41,44031000000,AZAILA
44,032,21,12,9,44032000000,BÁDENAS
44,033,270,151,119,44033000000,BÁGUENA
44,034,151,87,64,44034000000,BAÑÓN
44,035,120,66,54,44035000000,BARRACHINA
44,036,28,18,10,44036000000,BEA
44,037,569,286,283,44037000000,BECEITE
44,038,127,63,64,44038000000,BELMONTE DE SAN JOSÉ
44,039,217,109,108,44039000000,BELLO
44,040,226,116,110,44040000000,BERGE
44,041,64,39,25,44041000000,BEZAS
44,042,135,78,57,44042000000,BLANCAS
44,043,78,55,23,44043000000,BLESA
44,044,112,64,48,44044000000,BORDÓN
44,045,454,255,199,44045000000,BRONCHALES
44,046,54,27,27,44046000000,BUEÑA
44,047,376,208,168,44047000000,BURBÁGUENA
44,048,71,42,29,44048000000,CABRA DE MORA
44,049,979,485,494,44049000000,CALACEITE
44,050,4505,2262,2243,44050000000,CALAMOCHA
44,051,3759,1882,1877,44051000000,CALANDA
44,052,73,43,30,44052000000,CALOMARDE
44,053,132,72,60,44053000000,CAMAÑAS
44,054,134,74,60,44054000000,CAMARENA DE LA SIERRA
44,055,119,64,55,44055000000,CAMARILLAS
44,056,617,331,286,44056000000,CAMINREAL
44,059,726,378,348,44059000000,CANTAVIEJA
44,060,34,22,12,44060000000,CAÑADA DE BENATANDUZ
44,061,88,53,35,44061000000,LA CAÑADA DE VERICH (LA)
44,062,40,27,13,44062000000,CAÑADA VELLIDA
44,063,103,58,45,44063000000,CAÑIZAR DEL OLIVAR
44,064,70,41,29,44064000000,CASCANTE DEL RÍO
44,065,68,38,30,44065000000,CASTEJÓN DE TORNOS
44,066,89,49,40,44066000000,CASTEL DE CABRA
44,067,108,55,53,44067000000,CASTELNOU
44,068,795,421,374,44068000000,CASTELSERÁS
44,070,55,37,18,44070000000,EL CASTELLAR (EL)
44,071,678,345,333,44071000000,CASTELLOTE
44,074,653,332,321,44074000000,CEDRILLAS
44,075,345,198,147,44075000000,CELADAS
44,076,2644,1355,1289,44076000000,CELLA
44,077,75,49,26,44077000000,LA CEROLLERA (LA)
44,080,320,169,151,44080000000,LA CODOÑERA (LA)
44,082,113,59,54,44082000000,CORBALÁN
44,084,61,28,33,44084000000,CORTES DE ARAGÓN
44,085,61,38,23,44085000000,COSA
44,086,556,283,273,44086000000,CRETAS
44,087,90,51,39,44087000000,CRIVILLÉN
44,088,49,25,24,44088000000,LA CUBA (LA)
44,089,71,46,25,44089000000,CUBLA
44,090,78,51,27,44090000000,CUCALÓN
44,092,98,47,51,44092000000,EL CUERVO (EL)
44,093,119,66,53,44093000000,CUEVAS DE ALMUDÉN
44,094,135,70,65,44094000000,CUEVAS LABRADAS
44,096,176,90,86,44096000000,EJULVE
44,097,141,71,70,44097000000,ESCORIHUELA
44,099,766,415,351,44099000000,ESCUCHA
44,100,196,111,85,44100000000,ESTERCUEL
44,101,71,39,32,44101000000,FERRERUELA DE HUERVA
44,102,32,19,13,44102000000,FONFRÍA
44,103,159,89,70,44103000000,FORMICHE ALTO
44,105,84,45,39,44105000000,FÓRNOLES
44,106,222,124,98,44106000000,FORTANETE
44,107,279,144,135,44107000000,FOZ-CALANDA
44,108,463,250,213,44108000000,LA FRESNEDA (LA)
44,109,111,69,42,44109000000,FRÍAS DE ALBARRACÍN
44,110,37,25,12,44110000000,FUENFERRADA
44,111,81,47,34,44111000000,FUENTES CALIENTES
44,112,435,233,202,44112000000,FUENTES CLARAS
44,113,169,94,75,44113000000,FUENTES DE RUBIELOS
44,114,288,148,140,44114000000,FUENTESPALDA
44,115,144,74,70,44115000000,GALVE
44,116,91,48,43,44116000000,GARGALLO
44,117,452,248,204,44117000000,GEA DE ALBARRACÍN
44,118,192,109,83,44118000000,LA GINEBROSA (LA)
44,119,140,84,56,44119000000,GRIEGOS
44,120,242,128,114,44120000000,GUADALAVIAR
44,121,70,41,29,44121000000,GÚDAR
44,122,1797,926,871,44122000000,HÍJAR
44,123,104,59,45,44123000000,HINOJOSA DE JARQUE
44,124,87,44,43,44124000000,LA HOZ DE LA VIEJA (LA)
44,125,64,39,25,44125000000,HUESA DEL COMÚN
44,126,382,197,185,44126000000,LA IGLESUELA DEL CID (LA)
44,127,74,44,30,44127000000,JABALOYAS
44,128,64,31,33,44128000000,JARQUE DE LA VAL
44,129,46,27,19,44129000000,JATIEL
44,130,43,22,21,44130000000,JORCAS
44,131,37,25,12,44131000000,JOSA
44,132,72,43,29,44132000000,LAGUERUELA
44,133,28,19,9,44133000000,LANZUELA
44,135,101,62,39,44135000000,LIBROS
44,136,51,29,22,44136000000,LIDÓN
44,137,232,131,101,44137000000,LINARES DE MORA
44,138,116,73,43,44138000000,LOSCOS
44,141,171,89,82,44141000000,LLEDÓ
44,142,32,20,12,44142000000,MAICAS
44,143,540,298,242,44143000000,MANZANERA
44,144,370,175,195,44144000000,MARTÍN DEL RÍO
44,145,1237,635,602,44145000000,MAS DE LAS MATAS
44,146,281,151,130,44146000000,LA MATA DE LOS OLMOS (LA)
44,147,487,258,229,44147000000,MAZALEÓN
44,148,82,42,40,44148000000,MEZQUITA DE JARQUE
44,149,105,60,45,44149000000,MIRAMBEL
44,150,28,20,8,44150000000,MIRAVETE DE LA SIERRA
44,151,225,119,106,44151000000,MOLINOS
44,152,83,55,28,44152000000,MONFORTE DE MOYUELA
44,153,2486,1222,1264,44153000000,MONREAL DEL CAMPO
44,154,315,172,143,44154000000,MONROYO
44,155,1180,596,584,44155000000,MONTALBÁN
44,156,43,25,18,44156000000,MONTEAGUDO DEL CASTILLO
44,157,56,32,24,44157000000,MONTERDE DE ALBARRACÍN
44,158,1568,783,785,44158000000,MORA DE RUBIELOS
44,159,56,30,26,44159000000,MOSCARDÓN
44,160,538,294,244,44160000000,MOSQUERUELA
44,161,571,304,267,44161000000,MUNIESA
44,163,131,74,57,44163000000,NOGUERA DE ALBARRACÍN
44,164,32,21,11,44164000000,NOGUERAS
44,165,192,113,79,44165000000,NOGUERUELAS
44,167,35,21,14,44167000000,OBÓN
44,168,207,102,105,44168000000,ODÓN
44,169,330,185,145,44169000000,OJOS NEGROS
44,171,279,145,134,44171000000,OLBA
44,172,349,189,160,44172000000,OLIETE
44,173,119,69,50,44173000000,LOS OLMOS (LOS)
44,174,453,255,198,44174000000,ORIHUELA DEL TREMEDAL
44,175,122,67,55,44175000000,ORRIOS
44,176,167,98,69,44176000000,PALOMAR DE ARROYOS
44,177,114,67,47,44177000000,PANCRUDO
44,178,61,35,26,44178000000,LAS PARRAS DE CASTELLOTE (LAS)
44,179,443,234,209,44179000000,PEÑARROYA DE TASTAVINS
44,180,75,36,39,44180000000,PERACENSE
44,181,86,46,40,44181000000,PERALEJOS
44,182,264,132,132,44182000000,PERALES DEL ALFAMBRA
44,183,65,32,33,44183000000,PITARQUE
44,184,49,29,20,44184000000,PLOU
44,185,102,65,37,44185000000,EL POBO (EL)
44,187,242,124,118,44187000000,LA PORTELLADA (LA)
44,189,54,34,20,44189000000,POZONDÓN
44,190,66,36,30,44190000000,POZUEL DEL CAMPO
44,191,917,478,439,44191000000,LA PUEBLA DE HÍJAR (LA)
44,192,470,252,218,44192000000,LA PUEBLA DE VALVERDE (LA)
44,193,137,73,64,44193000000,PUERTOMINGALVO
44,194,150,87,63,44194000000,RÁFALES
44,195,97,58,39,44195000000,RILLO
44,196,132,62,70,44196000000,RIODEVA
44,197,62,34,28,44197000000,RÓDENAS
44,198,231,119,112,44198000000,ROYUELA
44,199,42,22,20,44199000000,RUBIALES
44,200,30,18,12,44200000000,RUBIELOS DE LA CÉRIDA
44,201,627,316,311,44201000000,RUBIELOS DE MORA
44,203,10,6,4,44203000000,SALCEDILLO
44,204,21,15,6,44204000000,SALDÓN
44,205,725,380,345,44205000000,SAMPER DE CALANDA
44,206,134,83,51,44206000000,SAN AGUSTÍN
44,207,135,69,66,44207000000,SAN MARTÍN DEL RÍO
44,208,23,15,8,44208000000,SANTA CRUZ DE NOGUERAS
44,209,1017,520,497,44209000000,SANTA EULALIA
44,210,1197,607,590,44210000000,SARRIÓN
44,211,42,27,15,44211000000,SEGURA DE LOS BAÑOS
44,212,41,18,23,44212000000,SENO
44,213,80,47,33,44213000000,SINGRA
44,215,206,120,86,44215000000,TERRIENTE
44,216,36267,17214,19053,44216000000,TERUEL
44,217,33,26,7,44217000000,TORIL Y MASEGOSO
44,218,33,20,13,44218000000,TORMÓN
44,219,191,102,89,44219000000,TORNOS
44,220,148,80,68,44220000000,TORRALBA DE LOS SISONES
44,221,440,233,207,44221000000,TORRECILLA DE ALCAÑIZ
44,222,125,79,46,44222000000,TORRECILLA DEL REBOLLAR
44,223,82,37,45,44223000000,TORRE DE ARCAS
44,224,24,13,11,44224000000,TORRE DE LAS ARCAS
44,225,118,62,56,44225000000,TORRE DEL COMPTE
44,226,135,79,56,44226000000,TORRELACÁRCEL
44,227,76,41,35,44227000000,TORRE LOS NEGROS
44,228,110,56,54,44228000000,TORREMOCHA DE JILOCA
44,229,191,102,89,44229000000,TORRES DE ALBARRACÍN
44,230,169,87,82,44230000000,TORREVELILLA
44,231,36,17,19,44231000000,TORRIJAS
44,232,502,260,242,44232000000,TORRIJO DEL CAMPO
44,234,62,35,27,44234000000,TRAMACASTIEL
44,235,109,52,57,44235000000,TRAMACASTILLA
44,236,61,33,28,44236000000,TRONCHÓN
44,237,447,228,219,44237000000,URREA DE GAÉN
44,238,3088,1579,1509,44238000000,UTRILLAS
44,239,26,14,12,44239000000,VALACLOCHE
44,240,192,110,82,44240000000,VALBONA
44,241,589,287,302,44241000000,VALDEALGORFA
44,243,31,17,14,44243000000,VALDECUENCA
44,244,80,49,31,44244000000,VALDELINARES
44,245,313,151,162,44245000000,VALDELTORMO
44,246,2517,1276,1241,44246000000,VALDERROBRES
44,247,331,168,163,44247000000,VALJUNQUERA
44,249,37,22,15,44249000000,EL VALLECILLO (EL)
44,250,20,12,8,44250000000,VEGUILLAS DE LA SIERRA
44,251,302,162,140,44251000000,VILLAFRANCA DEL CAMPO
44,252,93,58,35,44252000000,VILLAHERMOSA DEL CAMPO
44,256,44,25,19,44256000000,VILLANUEVA DEL REBOLLAR DE LA SIERRA
44,257,163,99,64,44257000000,VILLAR DEL COBO
44,258,59,35,24,44258000000,VILLAR DEL SALZ
44,260,181,102,79,44260000000,VILLARLUENGO
44,261,865,455,410,44261000000,VILLARQUEMADO
44,262,168,88,80,44262000000,VILLARROYA DE LOS PINARES
44,263,543,278,265,44263000000,VILLASTAR
44,264,326,183,143,44264000000,VILLEL
44,265,200,108,92,44265000000,VINACEITE
44,266,130,62,68,44266000000,VISIEDO
44,267,67,35,32,44267000000,VIVEL DEL RÍO MARTÍN
44,268,27,14,13,44268000000,LA ZOMA (LA)
45,001,2340,1180,1160,45001000000,AJOFRÍN
45,002,4149,2181,1968,45002000000,ALAMEDA DE LA SAGRA
45,003,735,375,360,45003000000,ALBARREAL DE TAJO
45,004,762,384,378,45004000000,ALCABÓN
45,005,283,133,150,45005000000,ALCAÑIZO
45,006,1640,824,816,45006000000,ALCAUDETE DE LA JARA
45,007,839,424,415,45007000000,ALCOLEA DE TAJO
45,008,204,106,98,45008000000,ALDEA EN CABO
45,009,452,233,219,45009000000,ALDEANUEVA DE BARBARROYA
45,010,414,211,203,45010000000,ALDEANUEVA DE SAN BARTOLOMÉ
45,011,333,174,159,45011000000,ALMENDRAL DE LA CAÑADA
45,012,926,467,459,45012000000,ALMONACID DE TOLEDO
45,013,2396,1261,1135,45013000000,ALMOROX
45,014,5215,2628,2587,45014000000,AÑOVER DE TAJO
45,015,1075,538,537,45015000000,ARCICÓLLAR
45,016,6961,3477,3484,45016000000,ARGÉS
45,017,292,142,150,45017000000,AZUTÁN
45,018,1039,554,485,45018000000,BARCIENCE
45,019,10978,5489,5489,45019000000,BARGAS
45,020,1492,772,720,45020000000,BELVÍS DE LA JARA
45,021,4114,2188,1926,45021000000,BOROX
45,022,377,187,190,45022000000,BUENAVENTURA
45,023,3647,1903,1744,45023000000,BURGUILLOS DE TOLEDO
45,024,1300,662,638,45024000000,BURUJÓN
45,025,2107,1091,1016,45025000000,CABAÑAS DE LA SAGRA
45,026,295,155,140,45026000000,CABAÑAS DE YEPES
45,027,356,196,160,45027000000,CABEZAMESADA
45,028,4754,2399,2355,45028000000,CALERA Y CHOZAS
45,029,202,102,100,45029000000,CALERUELA
45,030,498,274,224,45030000000,CALZADA DE OROPESA
45,031,4439,2305,2134,45031000000,CAMARENA
45,032,629,318,311,45032000000,CAMARENILLA
45,033,330,176,154,45033000000,EL CAMPILLO DE LA JARA (EL)
45,034,1765,923,842,45034000000,CAMUÑAS
45,035,398,209,189,45035000000,CARDIEL DE LOS MONTES
45,036,848,434,414,45036000000,CARMENA
45,037,1862,932,930,45037000000,EL CARPIO DE TAJO (EL)
45,038,5274,2736,2538,45038000000,CARRANQUE
45,039,270,133,137,45039000000,CARRICHES
45,040,2011,1067,944,45040000000,EL CASAR DE ESCALONA (EL)
45,041,6671,3470,3201,45041000000,CASARRUBIOS DEL MONTE
45,042,178,95,83,45042000000,CASASBUENAS
45,043,905,456,449,45043000000,CASTILLO DE BAYUELA
45,045,1973,1029,944,45045000000,CAZALEGAS
45,046,3191,1588,1603,45046000000,CEBOLLA
45,047,4204,2179,2025,45047000000,CEDILLO DEL CONDADO
45,048,421,227,194,45048000000,LOS CERRALBOS (LOS)
45,049,500,258,242,45049000000,CERVERA DE LOS MONTES
45,050,642,342,300,45050000000,CIRUELOS
45,051,2556,1344,1212,45051000000,COBEJA
45,052,4452,2238,2214,45052000000,COBISA
45,053,9805,4958,4847,45053000000,CONSUEGRA
45,054,5219,2739,2480,45054000000,CORRAL DE ALMAGUER
45,055,1264,657,607,45055000000,CUERVA
45,056,4751,2462,2289,45056000000,CHOZAS DE CANALES
45,057,254,126,128,45057000000,CHUECA
45,058,387,190,197,45058000000,DOMINGO PÉREZ
45,059,2223,1147,1076,45059000000,DOSBARRIOS
45,060,225,120,105,45060000000,ERUSTES
45,061,3669,1882,1787,45061000000,ESCALONA
45,062,1469,717,752,45062000000,ESCALONILLA
45,063,422,248,174,45063000000,ESPINOSO DEL REY
45,064,5778,2947,2831,45064000000,ESQUIVIAS
45,065,298,161,137,45065000000,LA ESTRELLA (LA)
45,066,12329,6241,6088,45066000000,FUENSALIDA
45,067,3002,1517,1485,45067000000,GÁLVEZ
45,068,215,107,108,45068000000,GARCIOTUM
45,069,2617,1321,1296,45069000000,GERINDOTE
45,070,1802,908,894,45070000000,GUADAMUR
45,071,2136,1082,1054,45071000000,LA GUARDIA (LA)
45,072,794,419,375,45072000000,LAS HERENCIAS (LAS)
45,073,317,172,145,45073000000,HERRERUELA DE OROPESA
45,074,381,209,172,45074000000,HINOJOSA DE SAN VICENTE
45,075,145,88,57,45075000000,HONTANAR
45,076,949,522,427,45076000000,HORMIGOS
45,077,849,436,413,45077000000,HUECAS
45,078,1760,892,868,45078000000,HUERTA DE VALDECARÁBANOS
45,079,444,236,208,45079000000,LA IGLESUELA DEL TIÉTAR (LA)
45,080,3,3,0,45080000000,ILLÁN DE VACAS
45,081,31327,15749,15578,45081000000,ILLESCAS
45,082,1306,644,662,45082000000,LAGARTERA
45,083,873,441,432,45083000000,LAYOS
45,084,2518,1311,1207,45084000000,LILLO
45,085,2639,1400,1239,45085000000,LOMINCHAR
45,086,597,313,284,45086000000,LUCILLOS
45,087,10169,5089,5080,45087000000,MADRIDEJOS
45,088,4038,2048,1990,45088000000,MAGÁN
45,089,1649,847,802,45089000000,MALPICA DE TAJO
45,090,394,200,194,45090000000,MANZANEQUE
45,091,496,246,250,45091000000,MAQUEDA
45,092,256,131,125,45092000000,MARJALIZA
45,093,157,78,79,45093000000,MARRUPE
45,094,430,215,215,45094000000,MASCARAQUE
45,095,881,432,449,45095000000,LA MATA (LA)
45,096,1259,657,602,45096000000,MAZARAMBROZ
45,097,1374,701,673,45097000000,MEJORADA
45,098,2482,1289,1193,45098000000,MENASALBAS
45,099,6019,3057,2962,45099000000,MÉNTRIDA
45,100,205,111,94,45100000000,MESEGAR DE TAJO
45,101,4779,2404,2375,45101000000,MIGUEL ESTEBAN
45,102,5069,2539,2530,45102000000,MOCEJÓN
45,103,394,210,184,45103000000,MOHEDAS DE LA JARA
45,104,573,307,266,45104000000,MONTEARAGÓN
45,105,381,201,180,45105000000,MONTESCLAROS
45,106,9782,4914,4868,45106000000,MORA
45,107,5151,2616,2535,45107000000,NAMBROCA
45,108,496,261,235,45108000000,LA NAVA DE RICOMALILLO (LA)
45,109,3618,1894,1724,45109000000,NAVAHERMOSA
45,110,1861,961,900,45110000000,NAVALCÁN
45,111,50,26,24,45111000000,NAVALMORALEJO
45,112,2134,1098,1036,45112000000,LOS NAVALMORALES (LOS)
45,113,1956,994,962,45113000000,LOS NAVALUCILLOS (LOS)
45,114,608,299,309,45114000000,NAVAMORCUENDE
45,115,3911,1964,1947,45115000000,NOBLEJAS
45,116,942,486,456,45116000000,NOEZ
45,117,907,491,416,45117000000,NOMBELA
45,118,3388,1728,1660,45118000000,NOVÉS
45,119,5455,2838,2617,45119000000,NUMANCIA DE LA SAGRA
45,120,159,89,70,45120000000,NUÑO GÓMEZ
45,121,13868,6935,6933,45121000000,OCAÑA
45,122,8705,4401,4304,45122000000,OLÍAS DEL REY
45,123,4916,2582,2334,45123000000,ONTÍGOLA
45,124,2600,1310,1290,45124000000,ORGAZ
45,125,2600,1245,1355,45125000000,OROPESA
45,126,419,224,195,45126000000,OTERO
45,127,1143,624,519,45127000000,PALOMEQUE
45,128,3551,1785,1766,45128000000,PANTOJA
45,129,126,70,56,45129000000,PAREDES DE ESCALONA
45,130,352,185,167,45130000000,PARRILLAS
45,131,337,195,142,45131000000,PELAHUSTÁN
45,132,3163,1622,1541,45132000000,PEPINO
45,133,3884,1949,1935,45133000000,POLÁN
45,134,2308,1168,1140,45134000000,PORTILLO DE TOLEDO
45,135,4952,2525,2427,45135000000,LA PUEBLA DE ALMORADIEL (LA)
45,136,7885,3985,3900,45136000000,LA PUEBLA DE MONTALBÁN (LA)
45,137,2158,1114,1044,45137000000,LA PUEBLANUEVA (LA)
45,138,1171,589,582,45138000000,EL PUENTE DEL ARZOBISPO (EL)
45,139,162,89,73,45139000000,PUERTO DE SAN VICENTE
45,140,1528,788,740,45140000000,PULGAR
45,141,1012,517,495,45141000000,QUERO
45,142,11119,5507,5612,45142000000,QUINTANAR DE LA ORDEN
45,143,1721,849,872,45143000000,QUISMONDO
45,144,975,519,456,45144000000,EL REAL DE SAN VICENTE (EL)
45,145,4876,2700,2176,45145000000,RECAS
45,146,109,56,53,45146000000,RETAMOSO DE LA JARA
45,147,806,404,402,45147000000,RIELVES
45,148,247,136,111,45148000000,ROBLEDO DEL MAZO
45,149,568,279,289,45149000000,EL ROMERAL (EL)
45,150,619,333,286,45150000000,SAN BARTOLOMÉ DE LAS ABIERTAS
45,151,724,375,349,45151000000,SAN MARTÍN DE MONTALBÁN
45,152,590,318,272,45152000000,SAN MARTÍN DE PUSA
45,153,1679,844,835,45153000000,SAN PABLO DE LOS MONTES
45,154,2071,1060,1011,45154000000,SAN ROMÁN DE LOS MONTES
45,155,346,205,141,45155000000,SANTA ANA DE PUSA
45,156,4098,2086,2012,45156000000,SANTA CRUZ DE LA ZARZA
45,157,3901,2016,1885,45157000000,SANTA CRUZ DEL RETAMAR
45,158,3436,1732,1704,45158000000,SANTA OLALLA
45,159,109,66,43,45159000000,SARTAJADA
45,160,1384,704,680,45160000000,SEGURILLA
45,161,29271,15046,14225,45161000000,SESEÑA
45,162,643,355,288,45162000000,SEVILLEJA DE LA JARA
45,163,11205,5704,5501,45163000000,SONSECA
45,164,173,88,85,45164000000,SOTILLO DE LAS PALOMAS
45,165,84137,40349,43788,45165000000,TALAVERA DE LA REINA
45,166,1955,989,966,45166000000,TEMBLEQUE
45,167,1667,833,834,45167000000,EL TOBOSO (EL)
45,168,86070,40930,45140,45168000000,TOLEDO
45,169,192,105,87,45169000000,TORRALBA DE OROPESA
45,170,211,117,94,45170000000,TORRECILLA DE LA JARA
45,171,1846,929,917,45171000000,LA TORRE DE ESTEBAN HAMBRÁN (LA)
45,172,701,356,345,45172000000,TORRICO
45,173,13885,6817,7068,45173000000,TORRIJOS
45,174,350,178,172,45174000000,TOTANÉS
45,175,702,352,350,45175000000,TURLEQUE
45,176,5723,2951,2772,45176000000,UGENA
45,177,2491,1255,1236,45177000000,URDA
45,179,559,283,276,45179000000,VALDEVERDEJA
45,180,4672,2346,2326,45180000000,VALMOJADO
45,181,2889,1482,1407,45181000000,VELADA
45,182,1139,574,565,45182000000,LAS VENTAS CON PEÑA AGUILERA (LAS)
45,183,4088,2148,1940,45183000000,LAS VENTAS DE RETAMOSA (LAS)
45,184,229,107,122,45184000000,LAS VENTAS DE SAN JULIÁN (LAS)
45,185,9511,4742,4769,45185000000,VILLACAÑAS
45,186,3569,1774,1795,45186000000,LA VILLA DE DON FADRIQUE (LA)
45,187,4846,2449,2397,45187000000,VILLAFRANCA DE LOS CABALLEROS
45,188,4162,2105,2057,45188000000,VILLALUENGA DE LA SAGRA
45,189,1056,537,519,45189000000,VILLAMIEL DE TOLEDO
45,190,498,255,243,45190000000,VILLAMINAYA
45,191,613,320,293,45191000000,VILLAMUELAS
45,192,2985,1534,1451,45192000000,VILLANUEVA DE ALCARDETE
45,193,695,356,339,45193000000,VILLANUEVA DE BOGAS
45,194,69,35,34,45194000000,VILLAREJO DE MONTALBÁN
45,195,2535,1288,1247,45195000000,VILLARRUBIA DE SANTIAGO
45,196,1851,923,928,45196000000,VILLASECA DE LA SAGRA
45,197,2604,1334,1270,45197000000,VILLASEQUILLA
45,198,2753,1410,1343,45198000000,VILLATOBAS
45,199,5970,3185,2785,45199000000,EL VISO DE SAN JUAN (EL)
45,200,5717,2908,2809,45200000000,LOS YÉBENES (LOS)
45,201,6176,3269,2907,45201000000,YELES
45,202,5397,2738,2659,45202000000,YEPES
45,203,4842,2486,2356,45203000000,YUNCLER
45,204,820,430,390,45204000000,YUNCLILLOS
45,205,11762,5986,5776,45205000000,YUNCOS
45,901,1165,608,557,45901000000,SANTO DOMINGO-CAUDILLA
46,001,1004,538,466,46001000000,ADEMUZ
46,002,1699,890,809,46002000000,ADOR
46,003,1161,583,578,46003000000,ATZENETA D'ALBAIDA
46,004,2400,1193,1207,46004000000,AGULLENT
46,005,29825,14492,15333,46005000000,ALAQUÀS
46,006,6102,3013,3089,46006000000,ALBAIDA
46,007,17024,8501,8523,46007000000,ALBAL
46,008,3411,1719,1692,46008000000,ALBALAT DE LA RIBERA
46,009,4158,2042,2116,46009000000,ALBALAT DELS SORELLS
46,010,1428,749,679,46010000000,ALBALAT DELS TARONGERS
46,011,10815,5387,5428,46011000000,ALBERIC
46,012,1389,727,662,46012000000,ALBORACHE
46,013,25792,12547,13245,46013000000,ALBORAIA/ALBORAYA
46,014,4343,2102,2241,46014000000,ALBUIXECH
46,015,10575,5277,5298,46015000000,ALCÀSSER
46,016,1414,708,706,46016000000,ALCÀNTERA DE XÚQUER
46,017,46421,22657,23764,46017000000,ALZIRA
46,018,635,334,301,46018000000,ALCUBLAS
46,019,12197,5999,6198,46019000000,L'ALCÚDIA (L')
46,020,5361,2631,2730,46020000000,L'ALCÚDIA DE CRESPINS (L')
46,021,33376,16712,16664,46021000000,ALDAIA
46,022,21879,10679,11200,46022000000,ALFAFAR
46,023,477,245,232,46023000000,ALFAUIR
46,024,611,304,307,46024000000,ALFARA DE LA BARONIA
46,025,3455,1602,1853,46025000000,ALFARA DEL PATRIARCA
46,026,1618,828,790,46026000000,ALFARP
46,027,1183,581,602,46027000000,ALFARRASÍ
46,028,527,281,246,46028000000,ALGAR DE PALANCIA
46,029,27438,13614,13824,46029000000,ALGEMESÍ
46,030,1109,547,562,46030000000,ALGÍMIA D'ALFARA
46,031,14442,7294,7148,46031000000,ALGINET
46,032,7504,3668,3836,46032000000,ALMÀSSERA
46,033,279,137,142,46033000000,ALMISERÀ
46,034,2519,1266,1253,46034000000,ALMOINES
46,035,8996,4476,4520,46035000000,ALMUSSAFES
46,036,667,366,301,46036000000,ALPUENTE
46,037,1523,742,781,46037000000,L'ALQUERIA DE LA COMTESSA (L')
46,038,311,208,103,46038000000,ANDILLA
46,039,2593,1298,1295,46039000000,ANNA
46,040,1114,542,572,46040000000,ANTELLA
46,041,381,213,168,46041000000,ARAS DE LOS OLMOS
46,042,4601,2323,2278,46042000000,AIELO DE MALFERIT
46,043,163,88,75,46043000000,AIELO DE RUGAT
46,044,5223,2573,2650,46044000000,AYORA
46,045,1595,818,777,46045000000,BARXETA
46,046,1476,767,709,46046000000,BARX
46,047,632,315,317,46047000000,BÈLGIDA
46,048,4811,2402,2409,46048000000,BELLREGUARD
46,049,306,156,150,46049000000,BELLÚS
46,050,168,100,68,46050000000,BENAGÉBER
46,051,11877,6043,5834,46051000000,BENAGUASIL
46,052,674,327,347,46052000000,BENAVITES
46,053,655,313,342,46053000000,BENEIXIDA
46,054,15879,7742,8137,46054000000,BENETÚSSER
46,055,1872,942,930,46055000000,BENIARJÓ
46,056,217,118,99,46056000000,BENIATJAR
46,057,599,291,308,46057000000,BENICOLET
46,058,2320,1127,1193,46058000000,BENIFAIRÓ DE LES VALLS
46,059,1554,767,787,46059000000,BENIFAIRÓ DE LA VALLDIGNA
46,060,11984,5895,6089,46060000000,BENIFAIÓ
46,061,484,236,248,46061000000,BENIFLÁ
46,062,5716,2907,2809,46062000000,BENIGÀNIM
46,063,2279,1154,1125,46063000000,BENIMODO
46,064,665,358,307,46064000000,BENIMUSLEM
46,065,2074,1050,1024,46065000000,BENIPARRELL
46,066,1571,742,829,46066000000,BENIRREDRÀ
46,067,2385,1176,1209,46067000000,BENISSANÓ
46,068,460,248,212,46068000000,BENISSODA
46,069,185,93,92,46069000000,BENISSUERA
46,070,26759,13321,13438,46070000000,BÉTERA
46,071,549,266,283,46071000000,BICORP
46,072,4115,2070,2045,46072000000,BOCAIRENT
46,073,1334,657,677,46073000000,BOLBAITE
46,074,3907,1912,1995,46074000000,BONREPÒS I MIRAMBELL
46,075,156,82,74,46075000000,BUFALI
46,076,783,398,385,46076000000,BUGARRA
46,077,9579,4765,4814,46077000000,BUÑOL
46,078,39702,19055,20647,46078000000,BURJASSOT
46,079,431,249,182,46079000000,CALLES
46,080,1189,611,578,46080000000,CAMPORROBLES
46,081,13162,6548,6614,46081000000,CANALS
46,082,7265,3653,3612,46082000000,CANET D'EN BERENGUER
46,083,20777,10335,10442,46083000000,CARCAIXENT
46,084,1826,879,947,46084000000,CÀRCER
46,085,16141,8089,8052,46085000000,CARLET
46,086,102,51,51,46086000000,CARRÍCOLA
46,087,146,72,74,46087000000,CASAS ALTAS
46,088,173,88,85,46088000000,CASAS BAJAS
46,089,3091,1556,1535,46089000000,CASINOS
46,090,2322,1181,1141,46090000000,CASTELLÓ DE RUGAT
46,091,149,80,69,46091000000,CASTELLONET DE LA CONQUESTA
46,092,297,159,138,46092000000,CASTIELFABIB
46,093,2939,1478,1461,46093000000,CATADAU
46,094,29316,14487,14829,46094000000,CATARROJA
46,095,693,362,331,46095000000,CAUDETE DE LAS FUENTES
46,096,360,186,174,46096000000,CERDÀ
46,097,1130,566,564,46097000000,COFRENTES
46,098,3118,1537,1581,46098000000,CORBERA
46,099,753,409,344,46099000000,CORTES DE PALLÁS
46,100,314,161,153,46100000000,COTES
46,101,1050,499,551,46101000000,QUART DE LES VALLS
46,102,25590,12425,13165,46102000000,QUART DE POBLET
46,103,1672,786,886,46103000000,QUARTELL
46,104,2190,1096,1094,46104000000,QUATRETONDA
46,105,23753,11958,11795,46105000000,CULLERA
46,106,1645,850,795,46106000000,CHELVA
46,107,2445,1221,1224,46107000000,CHELLA
46,108,483,255,228,46108000000,CHERA
46,109,8962,4622,4340,46109000000,CHESTE
46,110,30749,15155,15594,46110000000,XIRIVELLA
46,111,16750,8570,8180,46111000000,CHIVA
46,112,687,368,319,46112000000,CHULILLA
46,113,3348,1681,1667,46113000000,DAIMÚS
46,114,684,337,347,46114000000,DOMEÑO
46,115,340,195,145,46115000000,DOS AGUAS
46,116,19054,9344,9710,46116000000,L'ELIANA (L')
46,117,717,371,346,46117000000,EMPERADOR
46,118,4781,2392,2389,46118000000,ENGUERA
46,119,914,471,443,46119000000,L'ÉNOVA (L')
46,120,1598,774,824,46120000000,ESTIVELLA
46,121,114,56,58,46121000000,ESTUBENY
46,122,3619,1809,1810,46122000000,FAURA
46,123,2664,1365,1299,46123000000,FAVARA
46,124,951,492,459,46124000000,FONTANARS DELS ALFORINS
46,125,1004,496,508,46125000000,FORTALENY
46,126,7641,3733,3908,46126000000,FOIOS
46,127,3858,1934,1924,46127000000,LA FONT D'EN CARRÒS (LA)
46,128,2031,1034,997,46128000000,LA FONT DE LA FIGUERA (LA)
46,129,688,373,315,46129000000,FUENTERROBLES
46,130,1058,504,554,46130000000,GAVARDA
46,131,78108,38281,39827,46131000000,GANDIA
46,132,2778,1413,1365,46132000000,EL GENOVÉS (EL)
46,133,569,295,274,46133000000,GESTALGAR
46,134,3818,1937,1881,46134000000,GILET
46,135,13414,6463,6951,46135000000,GODELLA
46,136,4148,2137,2011,46136000000,GODELLETA
46,137,288,145,143,46137000000,LA GRANJA DE LA COSTERA (LA)
46,138,480,236,244,46138000000,GUADASSÉQUIES
46,139,5961,2885,3076,46139000000,GUADASSUAR
46,140,605,304,301,46140000000,GUARDAMAR DE LA SAFOR
46,141,522,276,246,46141000000,HIGUERUELAS
46,142,810,420,390,46142000000,JALANCE
46,143,5923,2974,2949,46143000000,XERACO
46,144,765,403,362,46144000000,JARAFUEL
46,145,30072,14717,15355,46145000000,XÀTIVA
46,146,2263,1136,1127,46146000000,XERESA
46,147,24518,12344,12174,46147000000,LLÍRIA
46,148,2171,1124,1047,46148000000,LORIGUILLA
46,149,520,261,259,46149000000,LOSA DEL OBISPO
46,150,2324,1181,1143,46150000000,LLUTXENT
46,151,908,466,442,46151000000,LLOCNOU D'EN FENOLLET
46,152,124,59,65,46152000000,LLOCNOU DE LA CORONA
46,153,567,284,283,46153000000,LLOCNOU DE SANT JERONI
46,154,1054,540,514,46154000000,LLANERA DE RANES
46,155,1208,610,598,46155000000,LLAURÍ
46,156,2687,1332,1355,46156000000,LLOMBAI
46,157,3681,1872,1809,46157000000,LA LLOSA DE RANES (LA)
46,158,1437,752,685,46158000000,MACASTRE
46,159,31573,15630,15943,46159000000,MANISES
46,160,2500,1244,1256,46160000000,MANUEL
46,161,1955,1007,948,46161000000,MARINES
46,162,1739,885,854,46162000000,MASSALAVÉS
46,163,2609,1300,1309,46163000000,MASSALFASSAR
46,164,16766,8264,8502,46164000000,MASSAMAGRELL
46,165,10146,4958,5188,46165000000,MASSANASSA
46,166,10918,5354,5564,46166000000,MELIANA
46,167,330,165,165,46167000000,MILLARES
46,168,2978,1493,1485,46168000000,MIRAMAR
46,169,45644,22137,23507,46169000000,MISLATA
46,170,4383,2195,2188,46170000000,MOIXENT/MOGENTE
46,171,22067,10710,11357,46171000000,MONCADA
46,172,9312,4815,4497,46172000000,MONTSERRAT
46,173,1617,800,817,46173000000,MONTAVERNER
46,174,1132,575,557,46174000000,MONTESA
46,175,558,274,284,46175000000,MONTITXELVO/MONTICHELVO
46,176,3295,1746,1549,46176000000,MONTROI/MONTROY
46,177,6741,3432,3309,46177000000,MUSEROS
46,178,8102,4182,3920,46178000000,NÀQUERA/NÁQUERA
46,179,3061,1529,1532,46179000000,NAVARRÉS
46,180,856,420,436,46180000000,NOVETLÈ/NOVELÉ
46,181,25558,12553,13005,46181000000,OLIVA
46,182,2303,1219,1084,46182000000,OLOCAU
46,183,8421,4237,4184,46183000000,L'OLLERIA (L')
46,184,36194,17842,18352,46184000000,ONTINYENT
46,185,436,221,215,46185000000,OTOS
46,186,27184,13312,13872,46186000000,PAIPORTA
46,187,1735,916,819,46187000000,PALMA DE GANDÍA
46,188,1043,522,521,46188000000,PALMERA
46,189,574,292,282,46189000000,EL PALOMAR (EL)
46,190,73488,36161,37327,46190000000,PATERNA
46,191,3048,1600,1448,46191000000,PEDRALBA
46,192,1096,545,551,46192000000,PETRÉS
46,193,11760,5825,5935,46193000000,PICANYA
46,194,22236,11164,11072,46194000000,PICASSENT
46,195,3031,1496,1535,46195000000,PILES
46,196,155,78,77,46196000000,PINET
46,197,2550,1309,1241,46197000000,POLINYÀ DE XÚQUER
46,198,1080,555,525,46198000000,POTRIES
46,199,8699,4371,4328,46199000000,LA POBLA DE FARNALS (LA)
46,200,2438,1174,1264,46200000000,LA POBLA DEL DUC (LA)
46,201,53,35,18,46201000000,PUEBLA DE SAN MIGUEL
46,202,26435,13258,13177,46202000000,LA POBLA DE VALLBONA (LA)
46,203,4529,2273,2256,46203000000,LA POBLA LLARGA (LA)
46,204,8992,4375,4617,46204000000,EL PUIG DE SANTA MARIA (EL)
46,205,20731,10212,10519,46205000000,PUÇOL
46,206,661,338,323,46206000000,QUESA
46,207,9467,4617,4850,46207000000,RAFELBUNYOL
46,208,1372,670,702,46208000000,RAFELCOFER
46,209,2351,1158,1193,46209000000,RAFELGUARAF
46,210,467,242,225,46210000000,RÁFOL DE SALEM
46,211,2649,1341,1308,46211000000,EL REAL DE GANDIA (EL)
46,212,2410,1248,1162,46212000000,REAL
46,213,20387,10230,10157,46213000000,REQUENA
46,214,23555,11887,11668,46214000000,RIBA-ROJA DE TÚRIA
46,215,1780,886,894,46215000000,RIOLA
46,216,7570,3695,3875,46216000000,ROCAFORT
46,217,1165,580,585,46217000000,ROTGLÀ I CORBERÀ
46,218,1292,655,637,46218000000,RÒTOVA
46,219,166,91,75,46219000000,RUGAT
46,220,70128,34175,35953,46220000000,SAGUNT/SAGUNTO
46,221,401,203,198,46221000000,SALEM
46,222,544,272,272,46222000000,SANT JOANET
46,223,10637,5225,5412,46223000000,SEDAVÍ
46,224,166,88,78,46224000000,SEGART
46,225,381,194,187,46225000000,SELLENT
46,226,31,16,15,46226000000,SEMPERE
46,227,1122,547,575,46227000000,SENYERA
46,228,3608,1826,1782,46228000000,SERRA
46,229,1229,636,593,46229000000,SIETE AGUAS
46,230,19683,9747,9936,46230000000,SILLA
46,231,3251,1613,1638,46231000000,SIMAT DE LA VALLDIGNA
46,232,1113,586,527,46232000000,SINARCAS
46,233,4959,2431,2528,46233000000,SOLLANA
46,234,423,225,198,46234000000,SOT DE CHERA
46,235,28086,13904,14182,46235000000,SUECA
46,236,1062,515,547,46236000000,SUMACÀRCER
46,237,9456,4599,4857,46237000000,TAVERNES BLANQUES
46,238,17443,8637,8806,46238000000,TAVERNES DE LA VALLDIGNA
46,239,611,317,294,46239000000,TERESA DE COFRENTES
46,240,291,150,141,46240000000,TERRATEIG
46,241,505,260,245,46241000000,TITAGUAS
46,242,404,219,185,46242000000,TORREBAJA
46,243,143,78,65,46243000000,TORRELLA
46,244,87295,42763,44532,46244000000,TORRENT
46,245,745,406,339,46245000000,TORRES TORRES
46,246,1352,675,677,46246000000,TOUS
46,247,1201,643,558,46247000000,TUÉJAR
46,248,7259,3785,3474,46248000000,TURÍS
46,249,11632,5799,5833,46249000000,UTIEL
46,250,807693,383065,424628,46250000000,VALÈNCIA
46,251,3063,1555,1508,46251000000,VALLADA
46,252,144,75,69,46252000000,VALLANCA
46,253,151,85,66,46253000000,VALLÉS
46,254,1164,626,538,46254000000,VENTA DEL MORO
46,255,4667,2304,2363,46255000000,VILALLONGA/VILLALONGA
46,256,10772,5562,5210,46256000000,VILAMARXANT
46,257,6891,3387,3504,46257000000,CASTELLÓ
46,258,3700,1878,1822,46258000000,VILLAR DEL ARZOBISPO
46,259,577,291,286,46259000000,VILLARGORDO DEL CABRIEL
46,260,3495,1690,1805,46260000000,VINALESA
46,261,2205,1148,1057,46261000000,YÁTOVA
46,262,235,127,108,46262000000,LA YESA (LA)
46,263,364,198,166,46263000000,ZARRA
46,902,410,208,202,46902000000,GÁTOVA
46,903,10200,5042,5158,46903000000,SAN ANTONIO DE BENAGÉBER
46,904,1134,573,561,46904000000,BENICULL DE XÚQUER
47,001,51,30,21,47001000000,ADALIA
47,002,19,12,7,47002000000,AGUASAL
47,003,266,159,107,47003000000,AGUILAR DE CAMPOS
47,004,1380,731,649,47004000000,ALAEJOS
47,005,645,344,301,47005000000,ALCAZARÉN
47,006,215,119,96,47006000000,ALDEA DE SAN MIGUEL
47,007,6035,3107,2928,47007000000,ALDEAMAYOR DE SAN MARTÍN
47,008,23,13,10,47008000000,ALMENARA DE ADAJA
47,009,103,63,40,47009000000,AMUSQUILLO
47,010,21946,10972,10974,47010000000,ARROYO DE LA ENCOMIENDA
47,011,554,303,251,47011000000,ATAQUINES
47,012,81,38,43,47012000000,BAHABÓN
47,013,99,55,44,47013000000,BARCIAL DE LA LOMA
47,014,51,28,23,47014000000,BARRUELO DEL VALLE
47,015,211,120,91,47015000000,BECILLA DE VALDERADUEY
47,016,69,38,31,47016000000,BENAFARCES
47,017,177,100,77,47017000000,BERCERO
47,018,37,22,15,47018000000,BERCERUELO
47,019,98,55,43,47019000000,BERRUECES
47,020,282,160,122,47020000000,BOBADILLA DEL CAMPO
47,021,76,41,35,47021000000,BOCIGAS
47,022,80,43,37,47022000000,BOCOS DE DUERO
47,023,4297,2164,2133,47023000000,BOECILLO
47,024,245,139,106,47024000000,BOLAÑOS DE CAMPOS
47,025,102,55,47,47025000000,BRAHOJOS DE MEDINA
47,026,72,42,30,47026000000,BUSTILLO DE CHAVES
47,027,3823,1948,1875,47027000000,CABEZÓN DE PISUERGA
47,028,36,19,17,47028000000,CABEZÓN DE VALDERADUEY
47,029,56,30,26,47029000000,CABREROS DEL MONTE
47,030,1035,579,456,47030000000,CAMPASPERO
47,031,202,117,85,47031000000,EL CAMPILLO (EL)
47,032,153,90,63,47032000000,CAMPORREDONDO
47,033,233,124,109,47033000000,CANALEJAS DE PEÑAFIEL
47,034,70,42,28,47034000000,CANILLAS DE ESGUEVA
47,035,945,511,434,47035000000,CARPIO
47,036,221,131,90,47036000000,CASASOLA DE ARIÓN
47,037,181,93,88,47037000000,CASTREJÓN DE TRABANCOS
47,038,130,72,58,47038000000,CASTRILLO DE DUERO
47,039,157,88,69,47039000000,CASTRILLO-TEJERIEGO
47,040,52,25,27,47040000000,CASTROBOL
47,041,146,93,53,47041000000,CASTRODEZA
47,042,51,35,16,47042000000,CASTROMEMBIBRE
47,043,331,177,154,47043000000,CASTROMONTE
47,044,387,212,175,47044000000,CASTRONUEVO DE ESGUEVA
47,045,790,390,400,47045000000,CASTRONUÑO
47,046,133,71,62,47046000000,CASTROPONCE
47,047,195,124,71,47047000000,CASTROVERDE DE CERRATO
47,048,183,110,73,47048000000,CEINOS DE CAMPOS
47,049,95,55,40,47049000000,CERVILLEGO DE LA CRUZ
47,050,5360,2747,2613,47050000000,CIGALES
47,051,356,188,168,47051000000,CIGUÑUELA
47,052,9182,4615,4567,47052000000,CISTÉRNIGA
47,053,143,72,71,47053000000,COGECES DE ÍSCAR
47,054,641,349,292,47054000000,COGECES DEL MONTE
47,055,218,122,96,47055000000,CORCOS
47,056,103,59,44,47056000000,CORRALES DE DUERO
47,057,389,222,167,47057000000,CUBILLAS DE SANTA MARTA
47,058,198,103,95,47058000000,CUENCA DE CAMPOS
47,059,121,76,45,47059000000,CURIEL DE DUERO
47,060,213,118,95,47060000000,ENCINAS DE ESGUEVA
47,061,266,148,118,47061000000,ESGUEVILLAS DE ESGUEVA
47,062,180,104,76,47062000000,FOMBELLIDA
47,063,106,58,48,47063000000,FOMPEDRAZA
47,064,36,22,14,47064000000,FONTIHOYUELO
47,065,854,455,399,47065000000,FRESNO EL VIEJO
47,066,2076,1067,1009,47066000000,FUENSALDAÑA
47,067,149,79,70,47067000000,FUENTE EL SOL
47,068,37,17,20,47068000000,FUENTE-OLMEDO
47,069,108,54,54,47069000000,GALLEGOS DE HORNIJA
47,070,33,20,13,47070000000,GATÓN DE CAMPOS
47,071,486,234,252,47071000000,GERIA
47,073,113,63,50,47073000000,HERRÍN DE CAMPOS
47,074,190,111,79,47074000000,HORNILLOS DE ERESMA
47,075,6326,3192,3134,47075000000,ÍSCAR
47,076,22672,11232,11440,47076000000,LAGUNA DE DUERO
47,077,253,159,94,47077000000,LANGAYO
47,078,165,89,76,47078000000,LOMOVIEJO
47,079,45,21,24,47079000000,LLANO DE OLMEDO
47,080,53,29,24,47080000000,MANZANILLO
47,081,45,21,24,47081000000,MARZALES
47,082,1008,510,498,47082000000,MATAPOZUELOS
47,083,103,56,47,47083000000,MATILLA DE LOS CAÑOS
47,084,1418,701,717,47084000000,MAYORGA
47,085,20090,9817,10273,47085000000,MEDINA DEL CAMPO
47,086,4483,2202,2281,47086000000,MEDINA DE RIOSECO
47,087,422,224,198,47087000000,MEGECES
47,088,113,59,54,47088000000,MELGAR DE ABAJO
47,089,168,96,72,47089000000,MELGAR DE ARRIBA
47,090,3331,1722,1609,47090000000,MOJADOS
47,091,81,45,36,47091000000,MONASTERIO DE VEGA
47,092,101,61,40,47092000000,MONTEALEGRE DE CAMPOS
47,093,848,454,394,47093000000,MONTEMAYOR DE PILILLA
47,094,139,75,64,47094000000,MORAL DE LA REINA
47,095,40,23,17,47095000000,MORALEJA DE LAS PANADERAS
47,096,131,74,57,47096000000,MORALES DE CAMPOS
47,097,330,181,149,47097000000,MOTA DEL MARQUÉS
47,098,667,340,327,47098000000,MUCIENTES
47,099,163,85,78,47099000000,LA MUDARRA (LA)
47,100,116,59,57,47100000000,MURIEL
47,101,1925,978,947,47101000000,NAVA DEL REY
47,102,282,162,120,47102000000,NUEVA VILLA DE LAS TORRES
47,103,321,181,140,47103000000,OLIVARES DE DUERO
47,104,3563,1780,1783,47104000000,OLMEDO
47,105,193,107,86,47105000000,OLMOS DE ESGUEVA
47,106,41,23,18,47106000000,OLMOS DE PEÑAFIEL
47,109,160,84,76,47109000000,PALAZUELO DE VEDIJA
47,110,490,245,245,47110000000,LA PARRILLA (LA)
47,111,1175,603,572,47111000000,LA PEDRAJA DE PORTILLO (LA)
47,112,3382,1720,1662,47112000000,PEDRAJAS DE SAN ESTEBAN
47,113,150,84,66,47113000000,PEDROSA DEL REY
47,114,5172,2638,2534,47114000000,PEÑAFIEL
47,115,337,182,155,47115000000,PEÑAFLOR DE HORNIJA
47,116,424,226,198,47116000000,PESQUERA DE DUERO
47,117,313,163,150,47117000000,PIÑA DE ESGUEVA
47,118,157,90,67,47118000000,PIÑEL DE ABAJO
47,119,89,48,41,47119000000,PIÑEL DE ARRIBA
47,121,590,335,255,47121000000,POLLOS
47,122,2371,1218,1153,47122000000,PORTILLO
47,123,530,281,249,47123000000,POZAL DE GALLINAS
47,124,494,266,228,47124000000,POZALDEZ
47,125,54,32,22,47125000000,POZUELO DE LA ORDEN
47,126,43,23,20,47126000000,PURAS
47,127,160,90,70,47127000000,QUINTANILLA DE ARRIBA
47,128,49,24,25,47128000000,QUINTANILLA DEL MOLAR
47,129,1004,531,473,47129000000,QUINTANILLA DE ONÉSIMO
47,130,99,51,48,47130000000,QUINTANILLA DE TRIGUEROS
47,131,171,87,84,47131000000,RÁBANO
47,132,48,27,21,47132000000,RAMIRO
47,133,3936,1993,1943,47133000000,RENEDO DE ESGUEVA
47,134,165,92,73,47134000000,ROALES DE CAMPOS
47,135,90,52,38,47135000000,ROBLADILLO
47,137,26,16,10,47137000000,ROTURAS
47,138,221,126,95,47138000000,RUBÍ DE BRACAMONTE
47,139,1118,574,544,47139000000,RUEDA
47,140,112,71,41,47140000000,SAELICES DE MAYORGA
47,141,106,60,46,47141000000,SALVADOR DE ZAPARDIEL
47,142,114,66,48,47142000000,SAN CEBRIÁN DE MAZOTE
47,143,100,59,41,47143000000,SAN LLORENTE
47,144,89,46,43,47144000000,SAN MARTÍN DE VALVENÍ
47,145,650,348,302,47145000000,SAN MIGUEL DEL ARROYO
47,146,353,181,172,47146000000,SAN MIGUEL DEL PINO
47,147,108,64,44,47147000000,SAN PABLO DE LA MORALEJA
47,148,437,240,197,47148000000,SAN PEDRO DE LATARCE
47,149,51,26,25,47149000000,SAN PELAYO
47,150,289,138,151,47150000000,SAN ROMÁN DE HORNIJA
47,151,23,14,9,47151000000,SAN SALVADOR
47,152,72,41,31,47152000000,SANTA EUFEMIA DEL ARROYO
47,153,111,60,51,47153000000,SANTERVÁS DE CAMPOS
47,154,184,108,76,47154000000,SANTIBÁÑEZ DE VALCORBA
47,155,4636,2353,2283,47155000000,SANTOVENIA DE PISUERGA
47,156,164,87,77,47156000000,SAN VICENTE DEL PALACIO
47,157,608,322,286,47157000000,SARDÓN DE DUERO
47,158,1038,544,494,47158000000,LA SECA (LA)
47,159,1128,587,541,47159000000,SERRADA
47,160,434,227,207,47160000000,SIETE IGLESIAS DE TRABANCOS
47,161,5493,2785,2708,47161000000,SIMANCAS
47,162,86,48,38,47162000000,TAMARIZ DE CAMPOS
47,163,283,144,139,47163000000,TIEDRA
47,164,388,210,178,47164000000,TORDEHUMOS
47,165,8681,4362,4319,47165000000,TORDESILLAS
47,166,253,118,135,47166000000,TORRECILLA DE LA ABADESA
47,167,229,115,114,47167000000,TORRECILLA DE LA ORDEN
47,168,24,16,8,47168000000,TORRECILLA DE LA TORRE
47,169,62,33,29,47169000000,TORRE DE ESGUEVA
47,170,53,32,21,47170000000,TORRE DE PEÑAFIEL
47,171,386,202,184,47171000000,TORRELOBATÓN
47,172,164,88,76,47172000000,TORRESCÁRCELA
47,173,1242,648,594,47173000000,TRASPINEDO
47,174,322,172,150,47174000000,TRIGUEROS DEL VALLE
47,175,8780,4452,4328,47175000000,TUDELA DE DUERO
47,176,207,102,105,47176000000,LA UNIÓN DE CAMPOS (LA)
47,177,95,59,36,47177000000,URONES DE CASTROPONCE
47,178,197,107,90,47178000000,URUEÑA
47,179,402,229,173,47179000000,VALBUENA DE DUERO
47,180,71,43,28,47180000000,VALDEARCOS DE LA VEGA
47,181,191,108,83,47181000000,VALDENEBRO DE LOS VALLES
47,182,1583,821,762,47182000000,VALDESTILLAS
47,183,126,62,64,47183000000,VALDUNQUILLO
47,184,704,384,320,47184000000,VALORIA LA BUENA
47,185,103,58,45,47185000000,VALVERDE DE CAMPOS
47,186,297459,139241,158218,47186000000,VALLADOLID
47,187,80,47,33,47187000000,VEGA DE RUIPONCE
47,188,91,51,40,47188000000,VEGA DE VALDETRONCO
47,189,163,85,78,47189000000,VELASCÁLVARO
47,190,112,56,56,47190000000,VELILLA
47,191,126,82,44,47191000000,VELLIZA
47,192,108,58,50,47192000000,VENTOSA DE LA CUESTA
47,193,2255,1170,1085,47193000000,VIANA DE CEGA
47,194,353,186,167,47194000000,VILORIA
47,195,504,271,233,47195000000,VILLABÁÑEZ
47,196,27,13,14,47196000000,VILLABARUZ DE CAMPOS
47,197,1034,549,485,47197000000,VILLABRÁGIMA
47,198,64,42,22,47198000000,VILLACARRALÓN
47,199,79,46,33,47199000000,VILLACID DE CAMPOS
47,200,74,49,25,47200000000,VILLACO
47,203,63,29,34,47203000000,VILLAFRADES DE CAMPOS
47,204,231,130,101,47204000000,VILLAFRANCA DE DUERO
47,205,453,245,208,47205000000,VILLAFRECHÓS
47,206,87,51,36,47206000000,VILLAFUERTE
47,207,283,166,117,47207000000,VILLAGARCÍA DE CAMPOS
47,208,54,30,24,47208000000,VILLAGÓMEZ LA NUEVA
47,209,31,20,11,47209000000,VILLALÁN DE CAMPOS
47,210,484,232,252,47210000000,VILLALAR DE LOS COMUNEROS
47,211,61,31,30,47211000000,VILLALBA DE LA LOMA
47,212,388,216,172,47212000000,VILLALBA DE LOS ALCORES
47,213,106,53,53,47213000000,VILLALBARBA
47,214,1526,751,775,47214000000,VILLALÓN DE CAMPOS
47,215,55,28,27,47215000000,VILLAMURIEL DE CAMPOS
47,216,125,70,55,47216000000,VILLÁN DE TORDESILLAS
47,217,2911,1518,1393,47217000000,VILLANUBLA
47,218,1235,653,582,47218000000,VILLANUEVA DE DUERO
47,219,58,26,32,47219000000,VILLANUEVA DE LA CONDESA
47,220,163,91,72,47220000000,VILLANUEVA DE LOS CABALLEROS
47,221,104,63,41,47221000000,VILLANUEVA DE LOS INFANTES
47,222,103,56,47,47222000000,VILLANUEVA DE SAN MANCIO
47,223,140,82,58,47223000000,VILLARDEFRADES
47,224,99,53,46,47224000000,VILLARMENTERO DE ESGUEVA
47,225,71,42,29,47225000000,VILLASEXMIR
47,226,152,85,67,47226000000,VILLAVAQUERÍN
47,227,55,31,24,47227000000,VILLAVELLID
47,228,546,289,257,47228000000,VILLAVERDE DE MEDINA
47,229,234,122,112,47229000000,VILLAVICENCIO DE LOS CABALLEROS
47,230,303,163,140,47230000000,WAMBA
47,231,6342,3213,3129,47231000000,ZARATÁN
47,232,116,67,49,47232000000,LA ZARZA (LA)
48,001,7708,3864,3844,48001000000,ABADIÑO
48,002,9402,4674,4728,48002000000,ABANTO Y CIÉRVANA-ABANTO ZIERBENA
48,003,19570,9577,9993,48003000000,AMOREBIETA-ETXANO
48,004,392,206,186,48004000000,AMOROTO
48,005,164,75,89,48005000000,ARAKALDO
48,006,389,198,191,48006000000,ARANTZAZU
48,007,470,255,215,48007000000,MUNITIBAR-ARBATZEGI GERRIKAITZ
48,008,726,381,345,48008000000,ARTZENTALES
48,009,991,494,497,48009000000,ARRANKUDIAGA-ZOLLO
48,010,581,300,281,48010000000,ARRIETA
48,011,11954,5869,6085,48011000000,ARRIGORRIAGA
48,012,2811,1397,1414,48012000000,BAKIO
48,013,101229,49025,52204,48013000000,BARAKALDO
48,014,1533,765,768,48014000000,BARRIKA
48,015,40413,19559,20854,48015000000,BASAURI
48,016,7454,3640,3814,48016000000,BERANGO
48,017,16878,8291,8587,48017000000,BERMEO
48,018,1216,661,555,48018000000,BERRIATUA
48,019,4543,2250,2293,48019000000,BERRIZ
48,020,346096,163991,182105,48020000000,BILBAO
48,021,1644,825,819,48021000000,BUSTURIA
48,022,2713,1408,1305,48022000000,KARRANTZA HARANA/VALLE DE CARRANZA
48,023,754,383,371,48023000000,ARTEA
48,024,1247,627,620,48024000000,ZEANURI
48,025,1081,547,534,48025000000,ZEBERIO
48,026,1496,768,728,48026000000,DIMA
48,027,29767,14516,15251,48027000000,DURANGO
48,028,822,430,392,48028000000,EA
48,029,11975,5969,6006,48029000000,ETXEBARRI
48,030,782,396,386,48030000000,ETXEBARRIA
48,031,348,167,181,48031000000,ELANTXOBE
48,032,7292,3582,3710,48032000000,ELORRIO
48,033,277,150,127,48033000000,EREÑO
48,034,15599,7726,7873,48034000000,ERMUA
48,035,551,273,278,48035000000,FRUIZ
48,036,29332,14414,14918,48036000000,GALDAKAO
48,037,834,445,389,48037000000,GALDAMES
48,038,1395,703,692,48038000000,GAMIZ-FIKA
48,039,334,163,171,48039000000,GARAI
48,040,1623,811,812,48040000000,GATIKA
48,041,889,443,446,48041000000,GAUTEGIZ ARTEAGA
48,042,1678,866,812,48042000000,GORDEXOLA
48,043,6058,2980,3078,48043000000,GORLIZ
48,044,76104,35602,40502,48044000000,GETXO
48,045,6740,3240,3500,48045000000,GÜEÑES
48,046,17050,8203,8847,48046000000,GERNIKA-LUMO
48,047,197,104,93,48047000000,GIZABURUAGA
48,048,695,358,337,48048000000,IBARRANGELU
48,049,731,379,352,48049000000,ISPASTER
48,050,227,147,80,48050000000,IZURTZA
48,051,246,135,111,48051000000,LANESTOSA
48,052,2056,1004,1052,48052000000,LARRABETZU
48,053,1225,600,625,48053000000,LAUKIZ
48,054,32491,15857,16634,48054000000,LEIOA
48,055,3547,1781,1766,48055000000,LEMOA
48,056,1318,691,627,48056000000,LEMOIZ
48,057,7143,3522,3621,48057000000,LEKEITIO
48,058,1160,591,569,48058000000,MALLABIA
48,059,533,273,260,48059000000,MAÑARIA
48,060,5037,2529,2508,48060000000,MARKINA-XEMEIN
48,061,1069,556,513,48061000000,MARURI-JATABE
48,062,385,200,185,48062000000,MENDATA
48,063,425,221,204,48063000000,MENDEXA
48,064,763,400,363,48064000000,MEÑAKA
48,065,4164,2089,2075,48065000000,UGAO-MIRABALLES
48,066,414,219,195,48066000000,MORGA
48,067,1517,796,721,48067000000,MUXIKA
48,068,1843,918,925,48068000000,MUNDAKA
48,069,17882,8689,9193,48069000000,MUNGIA
48,070,655,325,330,48070000000,AULESTI
48,071,7342,3567,3775,48071000000,MUSKIZ
48,072,1323,677,646,48072000000,OTXANDIO
48,073,8179,4069,4110,48073000000,ONDARROA
48,074,4179,2150,2029,48074000000,URDUÑA/ORDUÑA
48,075,2654,1318,1336,48075000000,OROZKO
48,076,355,185,170,48076000000,SUKARRIETA
48,077,4361,2123,2238,48077000000,PLENTZIA
48,078,44629,21309,23320,48078000000,PORTUGALETE
48,079,509,274,235,48079000000,ERRIGOITI
48,080,11911,5804,6107,48080000000,VALLE DE TRÁPAGA-TRAPAGARAN
48,081,2448,1220,1228,48081000000,LEZAMA
48,082,46057,22074,23983,48082000000,SANTURTZI
48,083,8536,4164,4372,48083000000,ORTUELLA
48,084,27834,13413,14421,48084000000,SESTAO
48,085,14872,7374,7498,48085000000,SOPELA
48,086,2731,1369,1362,48086000000,SOPUERTA
48,087,521,273,248,48087000000,TRUCIOS-TURTZIOZ
48,088,173,86,87,48088000000,UBIDE
48,089,5469,2690,2779,48089000000,URDULIZ
48,090,7593,3658,3935,48090000000,BALMASEDA
48,091,1367,688,679,48091000000,ATXONDO
48,092,1114,543,571,48092000000,BEDIA
48,093,1247,605,642,48093000000,AREATZA
48,094,4296,2115,2181,48094000000,IGORRE
48,095,3005,1533,1472,48095000000,ZALDIBAR
48,096,8319,4063,4256,48096000000,ZALLA
48,097,1610,808,802,48097000000,ZARATAMO
48,901,7071,3460,3611,48901000000,DERIO
48,902,24411,11784,12627,48902000000,ERANDIO
48,903,2297,1105,1192,48903000000,LOIU
48,904,4523,2177,2346,48904000000,SONDIKA
48,905,3294,1639,1655,48905000000,ZAMUDIO
48,906,916,444,472,48906000000,FORUA
48,907,440,214,226,48907000000,KORTEZUBI
48,908,337,176,161,48908000000,MURUETA
48,909,269,135,134,48909000000,NABARNIZ
48,910,3738,1854,1884,48910000000,IURRETA
48,911,478,250,228,48911000000,AJANGIZ
48,912,2950,1461,1489,48912000000,ALONSOTEGI
48,913,1496,786,710,48913000000,ZIERBENA
48,914,426,199,227,48914000000,ARRATZU
48,915,398,208,190,48915000000,ZIORTZA-BOLIBAR
49,002,64,35,29,49002000000,ABEZAMES
49,003,1048,551,497,49003000000,ALCAÑICES
49,004,107,59,48,49004000000,ALCUBILLA DE NOGALES
49,005,123,72,51,49005000000,ALFARAZ DE SAYAGO
49,006,142,75,67,49006000000,ALGODRE
49,007,393,207,186,49007000000,ALMARAZ DE DUERO
49,008,410,225,185,49008000000,ALMEIDA DE SAYAGO
49,009,430,218,212,49009000000,ANDAVÍAS
49,010,448,227,221,49010000000,ARCENILLAS
49,011,214,120,94,49011000000,ARCOS DE LA POLVOROSA
49,012,74,38,36,49012000000,ARGAÑÍN
49,013,214,111,103,49013000000,ARGUJILLO
49,014,116,62,54,49014000000,ARQUILLINOS
49,015,213,111,102,49015000000,ARRABALDE
49,016,228,99,129,49016000000,ASPARIEGOS
49,017,263,134,129,49017000000,ASTURIANOS
49,018,278,143,135,49018000000,AYOÓ DE VIDRIALES
49,019,243,125,118,49019000000,BARCIAL DEL BARCO
49,020,253,142,111,49020000000,BELVER DE LOS MONTES
49,021,17261,8323,8938,49021000000,BENAVENTE
49,022,276,150,126,49022000000,BENEGILES
49,023,998,530,468,49023000000,BERMILLO DE SAYAGO
49,024,664,338,326,49024000000,LA BÓVEDA DE TORO (LA)
49,025,178,105,73,49025000000,BRETÓ
49,026,209,109,100,49026000000,BRETOCINO
49,027,121,57,64,49027000000,BRIME DE SOG
49,028,103,62,41,49028000000,BRIME DE URZ
49,029,617,324,293,49029000000,BURGANES DE VALVERDE
49,030,84,48,36,49030000000,BUSTILLO DEL ORO
49,031,139,75,64,49031000000,CABAÑAS DE SAYAGO
49,032,292,147,145,49032000000,CALZADILLA DE TERA
49,033,736,373,363,49033000000,CAMARZANA DE TERA
49,034,423,225,198,49034000000,CAÑIZAL
49,035,204,115,89,49035000000,CAÑIZO
49,036,487,250,237,49036000000,CARBAJALES DE ALBA
49,037,185,103,82,49037000000,CARBELLINO
49,038,97,56,41,49038000000,CASASECA DE CAMPEÁN
49,039,361,193,168,49039000000,CASASECA DE LAS CHANAS
49,040,121,65,56,49040000000,CASTRILLO DE LA GUAREÑA
49,041,431,235,196,49041000000,CASTROGONZALO
49,042,206,107,99,49042000000,CASTRONUEVO
49,043,259,141,118,49043000000,CASTROVERDE DE CAMPOS
49,044,71,38,33,49044000000,CAZURRA
49,046,244,134,110,49046000000,CERECINOS DE CAMPOS
49,047,108,65,43,49047000000,CERECINOS DEL CARRIZAL
49,048,113,58,55,49048000000,CERNADILLA
49,050,536,297,239,49050000000,COBREROS
49,052,175,95,80,49052000000,COOMONTE
49,053,1036,535,501,49053000000,CORESES
49,054,928,457,471,49054000000,CORRALES DEL VINO
49,055,82,44,38,49055000000,COTANES DEL MONTE
49,056,303,151,152,49056000000,CUBILLOS
49,057,119,64,55,49057000000,CUBO DE BENAVENTE
49,058,315,172,143,49058000000,EL CUBO DE TIERRA DEL VINO (EL)
49,059,79,47,32,49059000000,CUELGAMURES
49,061,138,77,61,49061000000,ENTRALA
49,062,111,63,48,49062000000,ESPADAÑEDO
49,063,334,176,158,49063000000,FARAMONTANOS DE TÁBARA
49,064,494,258,236,49064000000,FARIZA
49,065,1142,582,560,49065000000,FERMOSELLE
49,066,464,223,241,49066000000,FERRERAS DE ABAJO
49,067,356,197,159,49067000000,FERRERAS DE ARRIBA
49,068,431,241,190,49068000000,FERRERUELA
49,069,326,161,165,49069000000,FIGUERUELA DE ARRIBA
49,071,783,409,374,49071000000,FONFRÍA
49,075,116,61,55,49075000000,FRESNO DE LA POLVOROSA
49,076,342,176,166,49076000000,FRESNO DE LA RIBERA
49,077,151,75,76,49077000000,FRESNO DE SAYAGO
49,078,130,70,60,49078000000,FRIERA DE VALVERDE
49,079,93,51,42,49079000000,FUENTE ENCALADA
49,080,639,339,300,49080000000,FUENTELAPEÑA
49,081,1588,806,782,49081000000,FUENTESAÚCO
49,082,380,202,178,49082000000,FUENTES DE ROPEL
49,083,48,27,21,49083000000,FUENTESECAS
49,084,290,156,134,49084000000,FUENTESPREADAS
49,085,996,504,492,49085000000,GALENDE
49,086,112,64,48,49086000000,GALLEGOS DEL PAN
49,087,473,271,202,49087000000,GALLEGOS DEL RÍO
49,088,96,53,43,49088000000,GAMONES
49,090,195,101,94,49090000000,GEMA
49,091,246,129,117,49091000000,GRANJA DE MORERUELA
49,092,112,62,50,49092000000,GRANUCILLO
49,093,315,162,153,49093000000,GUARRATE
49,094,233,124,109,49094000000,HERMISENDE
49,095,306,164,142,49095000000,LA HINIESTA (LA)
49,096,146,79,67,49096000000,JAMBRINA
49,097,81,55,26,49097000000,JUSTEL
49,098,195,108,87,49098000000,LOSACINO
49,099,96,54,42,49099000000,LOSACIO
49,100,306,159,147,49100000000,LUBIÁN
49,101,147,81,66,49101000000,LUELMO
49,102,175,94,81,49102000000,EL MADERAL (EL)
49,103,456,240,216,49103000000,MADRIDANOS
49,104,320,181,139,49104000000,MAHIDE
49,105,140,76,64,49105000000,MAIRE DE CASTROPONCE
49,107,108,50,58,49107000000,MALVA
49,108,450,236,214,49108000000,MANGANESES DE LA LAMPREANA
49,109,628,305,323,49109000000,MANGANESES DE LA POLVOROSA
49,110,356,192,164,49110000000,MANZANAL DE ARRIBA
49,111,127,65,62,49111000000,MANZANAL DEL BARCO
49,112,136,73,63,49112000000,MANZANAL DE LOS INFANTES
49,113,158,91,67,49113000000,MATILLA DE ARZÓN
49,114,35,19,16,49114000000,MATILLA LA SECA
49,115,163,93,70,49115000000,MAYALDE
49,116,352,184,168,49116000000,MELGAR DE TERA
49,117,425,217,208,49117000000,MICERECES DE TERA
49,118,198,111,87,49118000000,MILLES DE LA POLVOROSA
49,119,240,130,110,49119000000,MOLACILLOS
49,120,47,26,21,49120000000,MOLEZUELAS DE LA CARBALLEDA
49,121,396,209,187,49121000000,MOMBUEY
49,122,980,506,474,49122000000,MONFARRACINOS
49,123,551,300,251,49123000000,MONTAMARTA
49,124,263,155,108,49124000000,MORAL DE SAYAGO
49,125,1775,900,875,49125000000,MORALEJA DEL VINO
49,126,297,153,144,49126000000,MORALEJA DE SAYAGO
49,127,3079,1593,1486,49127000000,MORALES DEL VINO
49,128,525,260,265,49128000000,MORALES DE REY
49,129,917,469,448,49129000000,MORALES DE TORO
49,130,155,80,75,49130000000,MORALES DE VALVERDE
49,131,220,116,104,49131000000,MORALINA
49,132,321,160,161,49132000000,MORERUELA DE LOS INFANZONES
49,133,287,155,132,49133000000,MORERUELA DE TÁBARA
49,134,202,118,84,49134000000,MUELAS DE LOS CABALLEROS
49,135,590,318,272,49135000000,MUELAS DEL PAN
49,136,322,158,164,49136000000,MUGA DE SAYAGO
49,137,166,95,71,49137000000,NAVIANOS DE VALVERDE
49,138,197,107,90,49138000000,OLMILLOS DE CASTRO
49,139,160,81,79,49139000000,OTERO DE BODAS
49,141,297,152,145,49141000000,PAJARES DE LA LAMPREANA
49,142,239,124,115,49142000000,PALACIOS DEL PAN
49,143,239,122,117,49143000000,PALACIOS DE SANABRIA
49,145,204,114,90,49145000000,PEDRALBA DE LA PRADERÍA
49,146,282,145,137,49146000000,EL PEGO (EL)
49,147,300,150,150,49147000000,PELEAGONZALO
49,148,269,124,145,49148000000,PELEAS DE ABAJO
49,149,373,194,179,49149000000,PEÑAUSENDE
49,150,124,55,69,49150000000,PEQUE
49,151,669,356,313,49151000000,EL PERDIGÓN (EL)
49,152,506,280,226,49152000000,PERERUELA
49,153,159,91,68,49153000000,PERILLA DE CASTRO
49,154,99,56,43,49154000000,PÍAS
49,155,110,60,50,49155000000,PIEDRAHITA DE CASTRO
49,156,196,102,94,49156000000,PINILLA DE TORO
49,157,178,88,90,49157000000,PINO DEL ORO
49,158,225,113,112,49158000000,EL PIÑERO (EL)
49,159,277,145,132,49159000000,POBLADURA DEL VALLE
49,160,37,22,15,49160000000,POBLADURA DE VALDERADUEY
49,162,171,96,75,49162000000,PORTO
49,163,202,104,98,49163000000,POZOANTIGUO
49,164,155,87,68,49164000000,POZUELO DE TÁBARA
49,165,53,31,22,49165000000,PRADO
49,166,1376,667,709,49166000000,PUEBLA DE SANABRIA
49,167,181,99,82,49167000000,PUEBLICA DE VALVERDE
49,168,100,55,45,49168000000,QUINTANILLA DEL MONTE
49,169,45,25,20,49169000000,QUINTANILLA DEL OLMO
49,170,103,50,53,49170000000,QUINTANILLA DE URZ
49,171,629,332,297,49171000000,QUIRUELAS DE VIDRIALES
49,172,494,265,229,49172000000,RABANALES
49,173,320,164,156,49173000000,RÁBANO DE ALISTE
49,174,118,67,51,49174000000,REQUEJO
49,175,248,132,116,49175000000,REVELLINOS
49,176,618,344,274,49176000000,RIOFRÍO DE ALISTE
49,177,233,126,107,49177000000,RIONEGRO DEL PUENTE
49,178,1010,530,480,49178000000,ROALES
49,179,415,220,195,49179000000,ROBLEDA-CERVANTES
49,180,149,74,75,49180000000,ROELOS DE SAYAGO
49,181,316,170,146,49181000000,ROSINOS DE LA REQUEJADA
49,183,86,38,48,49183000000,SALCE
49,184,165,92,73,49184000000,SAMIR DE LOS CAÑOS
49,185,172,87,85,49185000000,SAN AGUSTÍN DEL POZO
49,186,240,122,118,49186000000,SAN CEBRIÁN DE CASTRO
49,187,1344,703,641,49187000000,SAN CRISTÓBAL DE ENTREVIÑAS
49,188,100,57,43,49188000000,SAN ESTEBAN DEL MOLAR
49,189,206,112,94,49189000000,SAN JUSTO
49,190,48,24,24,49190000000,SAN MARTÍN DE VALDERADUEY
49,191,260,134,126,49191000000,SAN MIGUEL DE LA RIBERA
49,192,117,61,56,49192000000,SAN MIGUEL DEL VALLE
49,193,429,229,200,49193000000,SAN PEDRO DE CEQUE
49,194,322,168,154,49194000000,SAN PEDRO DE LA NAVE-ALMENDRA
49,197,169,82,87,49197000000,SANTA CLARA DE AVEDILLO
49,199,238,118,120,49199000000,SANTA COLOMBA DE LAS MONJAS
49,200,1039,534,505,49200000000,SANTA CRISTINA DE LA POLVOROSA
49,201,268,135,133,49201000000,SANTA CROYA DE TERA
49,202,178,104,74,49202000000,SANTA EUFEMIA DEL BARCO
49,203,293,153,140,49203000000,SANTA MARÍA DE LA VEGA
49,204,52,24,28,49204000000,SANTA MARÍA DE VALVERDE
49,205,347,178,169,49205000000,SANTIBÁÑEZ DE TERA
49,206,853,435,418,49206000000,SANTIBÁÑEZ DE VIDRIALES
49,207,243,130,113,49207000000,SANTOVENIA
49,208,322,171,151,49208000000,SAN VICENTE DE LA CABEZA
49,209,447,250,197,49209000000,SAN VITERO
49,210,471,246,225,49210000000,SANZOLES
49,214,759,369,390,49214000000,TÁBARA
49,216,133,79,54,49216000000,TAPIOLES
49,219,8349,4081,4268,49219000000,TORO
49,220,134,73,61,49220000000,LA TORRE DEL VALLE (LA)
49,221,230,119,111,49221000000,TORREGAMONES
49,222,415,216,199,49222000000,TORRES DEL CARRIZAL
49,223,859,459,400,49223000000,TRABAZOS
49,224,171,96,75,49224000000,TREFACIO
49,225,127,71,56,49225000000,UÑA DE QUINTANA
49,226,254,142,112,49226000000,VADILLO DE LA GUAREÑA
49,227,406,210,196,49227000000,VALCABADO
49,228,58,37,21,49228000000,VALDEFINJAS
49,229,127,67,60,49229000000,VALDESCORRIEL
49,230,72,40,32,49230000000,VALLESA DE LA GUAREÑA
49,231,309,159,150,49231000000,VEGA DE TERA
49,232,89,40,49,49232000000,VEGA DE VILLALOBOS
49,233,77,42,35,49233000000,VEGALATRAVE
49,234,427,227,200,49234000000,VENIALBO
49,235,428,226,202,49235000000,VEZDEMARBÁN
49,236,82,40,42,49236000000,VIDAYANES
49,237,145,75,70,49237000000,VIDEMALA
49,238,260,141,119,49238000000,VILLABRÁZARO
49,239,603,309,294,49239000000,VILLABUENA DEL PUENTE
49,240,180,101,79,49240000000,VILLADEPERA
49,241,236,127,109,49241000000,VILLAESCUSA
49,242,449,231,218,49242000000,VILLAFÁFILA
49,243,108,54,54,49243000000,VILLAFERRUEÑA
49,244,64,35,29,49244000000,VILLAGERIZ
49,245,250,125,125,49245000000,VILLALAZÁN
49,246,215,121,94,49246000000,VILLALBA DE LA LAMPREANA
49,247,393,200,193,49247000000,VILLALCAMPO
49,248,207,105,102,49248000000,VILLALOBOS
49,249,72,35,37,49249000000,VILLALONSO
49,250,1417,685,732,49250000000,VILLALPANDO
49,251,153,82,71,49251000000,VILLALUBE
49,252,336,177,159,49252000000,VILLAMAYOR DE CAMPOS
49,255,372,198,174,49255000000,VILLAMOR DE LOS ESCUDEROS
49,256,265,144,121,49256000000,VILLANÁZAR
49,257,368,192,176,49257000000,VILLANUEVA DE AZOAGUE
49,258,128,68,60,49258000000,VILLANUEVA DE CAMPEÁN
49,259,86,42,44,49259000000,VILLANUEVA DE LAS PERAS
49,260,778,383,395,49260000000,VILLANUEVA DEL CAMPO
49,261,1798,908,890,49261000000,VILLARALBO
49,262,388,194,194,49262000000,VILLARDECIERVOS
49,263,48,27,21,49263000000,VILLAR DE FALLAVES
49,264,518,272,246,49264000000,VILLAR DEL BUEY
49,265,115,58,57,49265000000,VILLARDIEGUA DE LA RIBERA
49,266,67,39,28,49266000000,VILLÁRDIGA
49,267,138,82,56,49267000000,VILLARDONDIEGO
49,268,397,210,187,49268000000,VILLARRÍN DE CAMPOS
49,269,215,101,114,49269000000,VILLASECO DEL PAN
49,270,156,98,58,49270000000,VILLAVENDIMIO
49,271,172,92,80,49271000000,VILLAVEZA DEL AGUA
49,272,68,35,33,49272000000,VILLAVEZA DE VALVERDE
49,273,158,86,72,49273000000,VIÑAS
49,275,59259,27397,31862,49275000000,ZAMORA
50,001,86,55,31,50001000000,ABANTO
50,002,139,81,58,50002000000,ACERED
50,003,134,76,58,50003000000,AGÓN
50,004,580,314,266,50004000000,AGUARÓN
50,005,268,148,120,50005000000,AGUILÓN
50,006,1055,554,501,50006000000,AINZÓN
50,007,64,41,23,50007000000,ALADRÉN
50,008,7257,3634,3623,50008000000,ALAGÓN
50,009,94,52,42,50009000000,ALARBA
50,010,82,46,36,50010000000,ALBERITE DE SAN JUAN
50,011,141,70,71,50011000000,ALBETA
50,012,105,58,47,50012000000,ALBORGE
50,013,240,113,127,50013000000,ALCALÁ DE EBRO
50,014,151,85,66,50014000000,ALCALÁ DE MONCAYO
50,015,76,45,31,50015000000,ALCONCHEL DE ARIZA
50,016,51,36,15,50016000000,ALDEHUELA DE LIESTOS
50,017,2439,1238,1201,50017000000,ALFAJARÍN
50,018,1472,763,709,50018000000,ALFAMÉN
50,019,65,38,27,50019000000,ALFORQUE
50,020,925,486,439,50020000000,ALHAMA DE ARAGÓN
50,021,20,11,9,50021000000,ALMOCHUEL
50,022,548,270,278,50022000000,LA ALMOLDA (LA)
50,023,227,115,112,50023000000,ALMONACID DE LA CUBA
50,024,775,445,330,50024000000,ALMONACID DE LA SIERRA
50,025,7914,4113,3801,50025000000,LA ALMUNIA DE DOÑA GODINA (LA)
50,026,570,298,272,50026000000,ALPARTIR
50,027,248,124,124,50027000000,AMBEL
50,028,111,81,30,50028000000,ANENTO
50,029,676,347,329,50029000000,ANIÑÓN
50,030,214,122,92,50030000000,AÑÓN DE MONCAYO
50,031,129,85,44,50031000000,ARANDA DE MONCAYO
50,032,266,148,118,50032000000,ARÁNDIGA
50,033,76,47,29,50033000000,ARDISA
50,034,1059,537,522,50034000000,ARIZA
50,035,80,45,35,50035000000,ARTIEDA
50,036,101,55,46,50036000000,ASÍN
50,037,137,81,56,50037000000,ATEA
50,038,1697,884,813,50038000000,ATECA
50,039,527,292,235,50039000000,AZUARA
50,040,75,41,34,50040000000,BADULES
50,041,18,8,10,50041000000,BAGÜÉS
50,042,17,5,12,50042000000,BALCONCHÁN
50,043,289,162,127,50043000000,BÁRBOLES
50,044,232,116,116,50044000000,BARDALLUR
50,045,1530,773,757,50045000000,BELCHITE
50,046,178,99,79,50046000000,BELMONTE DE GRACIÁN
50,047,37,26,11,50047000000,BERDEJO
50,048,33,20,13,50048000000,BERRUECO
50,050,95,64,31,50050000000,BIJUESCA
50,051,855,428,427,50051000000,BIOTA
50,052,84,44,40,50052000000,BISIMBRE
50,053,780,390,390,50053000000,BOQUIÑENI
50,054,49,30,19,50054000000,BORDALBA
50,055,5076,2579,2497,50055000000,BORJA
50,056,574,310,264,50056000000,BOTORRITA
50,057,1522,771,751,50057000000,BREA DE ARAGÓN
50,058,59,29,30,50058000000,BUBIERCA
50,059,967,497,470,50059000000,BUJARALOZ
50,060,242,131,111,50060000000,BULBUENTE
50,061,212,112,100,50061000000,BURETA
50,062,2660,1342,1318,50062000000,EL BURGO DE EBRO (EL)
50,063,64,36,28,50063000000,EL BUSTE (EL)
50,064,487,255,232,50064000000,CABAÑAS DE EBRO
50,065,46,27,19,50065000000,CABOLAFUENTE
50,066,4486,2350,2136,50066000000,CADRETE
50,067,19677,9659,10018,50067000000,CALATAYUD
50,068,2889,1500,1389,50068000000,CALATORAO
50,069,75,44,31,50069000000,CALCENA
50,070,58,33,25,50070000000,CALMARZA
50,071,119,70,49,50071000000,CAMPILLO DE ARAGÓN
50,072,186,100,86,50072000000,CARENAS
50,073,3397,1716,1681,50073000000,CARIÑENA
50,074,10336,5479,4857,50074000000,CASPE
50,075,89,58,31,50075000000,CASTEJÓN DE ALARBA
50,076,86,44,42,50076000000,CASTEJÓN DE LAS ARMAS
50,077,202,102,100,50077000000,CASTEJÓN DE VALDEJASA
50,078,217,113,104,50078000000,CASTILISCAR
50,079,272,154,118,50079000000,CERVERA DE LA CAÑADA
50,080,37,25,12,50080000000,CERVERUELA
50,081,564,288,276,50081000000,CETINA
50,082,87,43,44,50082000000,CIMBALLA
50,083,104,52,52,50083000000,CINCO OLIVAS
50,084,74,42,32,50084000000,CLARÉS DE RIBOTA
50,085,213,117,96,50085000000,CODO
50,086,228,149,79,50086000000,CODOS
50,087,38,22,16,50087000000,CONTAMINA
50,088,335,171,164,50088000000,COSUENDA
50,089,14701,7460,7241,50089000000,CUARTE DE HUERVA
50,090,148,69,79,50090000000,CUBEL
50,091,41,22,19,50091000000,LAS CUERLAS (LAS)
50,092,531,275,256,50092000000,CHIPRANA
50,093,94,50,44,50093000000,CHODES
50,094,1957,963,994,50094000000,DAROCA
50,095,17135,8797,8338,50095000000,EJEA DE LOS CABALLEROS
50,096,31,18,13,50096000000,EMBID DE ARIZA
50,098,183,97,86,50098000000,ENCINACORBA
50,099,4494,2320,2174,50099000000,ÉPILA
50,100,363,184,179,50100000000,ERLA
50,101,1174,595,579,50101000000,ESCATRÓN
50,102,1065,585,480,50102000000,FABARA
50,104,408,201,207,50104000000,FARLETE
50,105,422,241,181,50105000000,FAYÓN
50,106,128,70,58,50106000000,LOS FAYOS (LOS)
50,107,1250,618,632,50107000000,FIGUERUELAS
50,108,57,32,25,50108000000,FOMBUENA
50,109,126,79,47,50109000000,EL FRAGO (EL)
50,110,363,203,160,50110000000,EL FRASNO (EL)
50,111,200,110,90,50111000000,FRÉSCANO
50,113,756,406,350,50113000000,FUENDEJALÓN
50,114,150,87,63,50114000000,FUENDETODOS
50,115,4626,2403,2223,50115000000,FUENTES DE EBRO
50,116,219,121,98,50116000000,FUENTES DE JILOCA
50,117,123,68,55,50117000000,GALLOCANTA
50,118,2576,1298,1278,50118000000,GALLUR
50,119,996,524,472,50119000000,GELSA
50,120,61,34,27,50120000000,GODOJOS
50,121,307,163,144,50121000000,GOTOR
50,122,93,52,41,50122000000,GRISEL
50,123,646,331,315,50123000000,GRISÉN
50,124,502,278,224,50124000000,HERRERA DE LOS NAVARROS
50,125,378,196,182,50125000000,IBDES
50,126,2711,1381,1330,50126000000,ILLUECA
50,128,33,16,17,50128000000,ISUERRE
50,129,281,157,124,50129000000,JARABA
50,130,399,209,190,50130000000,JARQUE DE MONCAYO
50,131,291,155,136,50131000000,JAULÍN
50,132,1152,587,565,50132000000,LA JOYOSA (LA)
50,133,111,62,49,50133000000,LAGATA
50,134,115,61,54,50134000000,LANGA DEL CASTILLO
50,135,96,54,42,50135000000,LAYANA
50,136,616,318,298,50136000000,LÉCERA
50,137,1103,563,540,50137000000,LECIÑENA
50,138,46,27,19,50138000000,LECHÓN
50,139,337,183,154,50139000000,LETUX
50,140,196,115,81,50140000000,LITAGO
50,141,123,63,60,50141000000,LITUÉNIGO
50,142,26,14,12,50142000000,LOBERA DE ONSELLA
50,143,852,511,341,50143000000,LONGARES
50,144,44,27,17,50144000000,LONGÁS
50,146,234,126,108,50146000000,LUCENA DE JALÓN
50,147,990,500,490,50147000000,LUCENI
50,148,335,179,156,50148000000,LUESIA
50,149,39,22,17,50149000000,LUESMA
50,150,848,446,402,50150000000,LUMPIAQUE
50,151,680,361,319,50151000000,LUNA
50,152,2100,1149,951,50152000000,MAELLA
50,153,1110,574,536,50153000000,MAGALLÓN
50,154,176,94,82,50154000000,MAINAR
50,155,79,53,26,50155000000,MALANQUILLA
50,156,268,147,121,50156000000,MALEJÁN
50,157,431,216,215,50157000000,MALÓN
50,159,902,456,446,50159000000,MALUENDA
50,160,2939,1520,1419,50160000000,MALLÉN
50,161,99,54,45,50161000000,MANCHONES
50,162,163,77,86,50162000000,MARA
50,163,6335,3194,3141,50163000000,MARÍA DE HUERVA
50,164,441,220,221,50164000000,MEDIANA DE ARAGÓN
50,165,2272,1144,1128,50165000000,MEQUINENZA
50,166,260,138,122,50166000000,MESONES DE ISUELA
50,167,224,120,104,50167000000,MEZALOCHA
50,168,26,14,12,50168000000,MIANOS
50,169,425,222,203,50169000000,MIEDES DE ARAGÓN
50,170,384,211,173,50170000000,MONEGRILLO
50,171,124,72,52,50171000000,MONEVA
50,172,175,107,68,50172000000,MONREAL DE ARIZA
50,173,160,105,55,50173000000,MONTERDE
50,174,87,56,31,50174000000,MONTÓN
50,175,1058,528,530,50175000000,MORATA DE JALÓN
50,176,251,143,108,50176000000,MORATA DE JILOCA
50,177,304,162,142,50177000000,MORÉS
50,178,285,146,139,50178000000,MOROS
50,179,241,138,103,50179000000,MOYUELA
50,180,129,68,61,50180000000,MOZOTA
50,181,1450,756,694,50181000000,MUEL
50,182,6416,3333,3083,50182000000,LA MUELA (LA)
50,183,369,195,174,50183000000,MUNÉBREGA
50,184,106,58,48,50184000000,MURERO
50,185,203,119,84,50185000000,MURILLO DE GÁLLEGO
50,186,38,23,15,50186000000,NAVARDÚN
50,187,60,35,25,50187000000,NIGÜELLA
50,188,37,21,16,50188000000,NOMBREVILLA
50,189,1025,559,466,50189000000,NONASPE
50,190,846,448,398,50190000000,NOVALLAS
50,191,509,256,253,50191000000,NOVILLAS
50,192,317,172,145,50192000000,NUÉVALOS
50,193,912,454,458,50193000000,NUEZ DE EBRO
50,194,102,56,46,50194000000,OLVÉS
50,195,59,37,22,50195000000,ORCAJO
50,196,103,57,46,50196000000,ORERA
50,197,91,55,36,50197000000,ORÉS
50,198,47,32,15,50198000000,OSEJA
50,199,400,203,197,50199000000,OSERA DE EBRO
50,200,594,324,270,50200000000,PANIZA
50,201,584,309,275,50201000000,PARACUELLOS DE JILOCA
50,202,115,64,51,50202000000,PARACUELLOS DE LA RIBERA
50,203,1316,644,672,50203000000,PASTRIZ
50,204,3667,1899,1768,50204000000,PEDROLA
50,205,99,49,50,50205000000,LAS PEDROSAS (LAS)
50,206,552,300,252,50206000000,PERDIGUERA
50,207,89,51,38,50207000000,PIEDRATAJADA
50,208,2456,1253,1203,50208000000,PINA DE EBRO
50,209,4342,2224,2118,50209000000,PINSEQUE
50,210,40,27,13,50210000000,LOS PINTANOS (LOS)
50,211,353,194,159,50211000000,PLASENCIA DE JALÓN
50,212,34,13,21,50212000000,PLEITAS
50,213,105,58,47,50213000000,PLENAS
50,214,26,19,7,50214000000,POMER
50,215,23,12,11,50215000000,POZUEL DE ARIZA
50,216,257,138,119,50216000000,POZUELO DE ARAGÓN
50,217,558,308,250,50217000000,PRADILLA DE EBRO
50,218,131,75,56,50218000000,PUEBLA DE ALBORTÓN
50,219,6414,3274,3140,50219000000,LA PUEBLA DE ALFINDÉN (LA)
50,220,44,28,16,50220000000,PUENDELUNA
50,221,30,19,11,50221000000,PURUJOSA
50,222,1869,953,916,50222000000,QUINTO
50,223,1010,508,502,50223000000,REMOLINOS
50,224,71,38,33,50224000000,RETASCÓN
50,225,2987,1619,1368,50225000000,RICLA
50,227,149,79,70,50227000000,ROMANOS
50,228,323,171,152,50228000000,RUEDA DE JALÓN
50,229,70,29,41,50229000000,RUESCA
50,230,1263,637,626,50230000000,SÁDABA
50,231,351,175,176,50231000000,SALILLAS DE JALÓN
50,232,204,101,103,50232000000,SALVATIERRA DE ESCA
50,233,92,49,43,50233000000,SAMPER DEL SALZ
50,234,271,155,116,50234000000,SAN MARTÍN DE LA VIRGEN DE MONCAYO
50,235,3441,1752,1689,50235000000,SAN MATEO DE GÁLLEGO
50,236,97,65,32,50236000000,SANTA CRUZ DE GRÍO
50,237,126,68,58,50237000000,SANTA CRUZ DE MONCAYO
50,238,94,53,41,50238000000,SANTA EULALIA DE GÁLLEGO
50,239,67,42,25,50239000000,SANTED
50,240,1088,545,543,50240000000,SÁSTAGO
50,241,673,355,318,50241000000,SABIÑÁN
50,242,108,62,46,50242000000,SEDILES
50,243,341,196,145,50243000000,SESTRICA
50,244,271,138,133,50244000000,SIERRA DE LUNA
50,245,70,39,31,50245000000,SIGÜÉS
50,246,44,28,16,50246000000,SISAMÓN
50,247,1116,533,583,50247000000,SOBRADIEL
50,248,583,310,273,50248000000,SOS DEL REY CATÓLICO
50,249,315,193,122,50249000000,TABUENCA
50,250,84,41,43,50250000000,TALAMANTES
50,251,10720,5319,5401,50251000000,TARAZONA
50,252,6828,3426,3402,50252000000,TAUSTE
50,253,550,301,249,50253000000,TERRER
50,254,174,99,75,50254000000,TIERGA
50,255,201,108,93,50255000000,TOBED
50,256,72,39,33,50256000000,TORRALBA DE LOS FRAILES
50,257,176,95,81,50257000000,TORRALBA DE RIBOTA
50,258,43,27,16,50258000000,TORRALBILLA
50,259,73,36,37,50259000000,TORREHERMOSA
50,260,32,21,11,50260000000,TORRELAPAJA
50,261,237,126,111,50261000000,TORRELLAS
50,262,1498,783,715,50262000000,TORRES DE BERRELLÉN
50,263,201,118,83,50263000000,TORRIJO DE LA CAÑADA
50,264,163,96,67,50264000000,TOSOS
50,265,83,46,37,50265000000,TRASMOZ
50,266,123,73,50,50266000000,TRASOBARES
50,267,625,299,326,50267000000,UNCASTILLO
50,268,52,29,23,50268000000,UNDUÉS DE LERDA
50,269,438,247,191,50269000000,URREA DE JALÓN
50,270,49,23,26,50270000000,URRIÉS
50,271,269,146,123,50271000000,USED
50,272,18955,9378,9577,50272000000,UTEBO
50,273,32,19,13,50273000000,VALDEHORNA
50,274,62,38,24,50274000000,VAL DE SAN MARTÍN
50,275,126,76,50,50275000000,VALMADRID
50,276,136,67,69,50276000000,VALPALMAS
50,277,72,36,36,50277000000,VALTORRES
50,278,202,106,96,50278000000,VELILLA DE EBRO
50,279,67,31,36,50279000000,VELILLA DE JILOCA
50,280,315,171,144,50280000000,VERA DE MONCAYO
50,281,85,47,38,50281000000,VIERLAS
50,282,63,34,29,50282000000,LA VILUEÑA (LA)
50,283,82,45,37,50283000000,VILLADOZ
50,284,146,87,59,50284000000,VILLAFELICHE
50,285,840,432,408,50285000000,VILLAFRANCA DE EBRO
50,286,91,41,50,50286000000,VILLALBA DE PEREJIL
50,287,289,159,130,50287000000,VILLALENGUA
50,288,4806,2401,2405,50288000000,VILLANUEVA DE GÁLLEGO
50,289,69,34,35,50289000000,VILLANUEVA DE JILOCA
50,290,385,203,182,50290000000,VILLANUEVA DE HUERVA
50,291,148,82,66,50291000000,VILLAR DE LOS NAVARROS
50,292,278,157,121,50292000000,VILLARREAL DE HUERVA
50,293,430,230,200,50293000000,VILLARROYA DE LA SIERRA
50,294,71,39,32,50294000000,VILLARROYA DEL CAMPO
50,295,51,30,21,50295000000,VISTABELLA
50,296,439,224,215,50296000000,LA ZAIDA (LA)
50,297,682513,326270,356243,50297000000,ZARAGOZA
50,298,8677,4455,4222,50298000000,ZUERA
50,901,167,103,64,50901000000,BIEL
50,902,87,45,42,50902000000,MARRACOS
50,903,2866,1455,1411,50903000000,VILLAMAYOR DE GÁLLEGO
51,001,83039,41894,41145,51001000000,CEUTA
52,001,85491,43047,42444,52001000000,MELILLA
